STATE/UT,Year,CAUSE,Male,Female,Total
ANDHRA PRADESH,2001,Truck/Lorry (Government),103,26,129
ANDHRA PRADESH,2001,Truck/Lorry (Private),2171,414,2585
ANDHRA PRADESH,2001,Bus (Government),488,119,607
ANDHRA PRADESH,2001,Bus (Private),289,76,365
ANDHRA PRADESH,2001,Tempo/Vans (Government),13,3,16
ANDHRA PRADESH,2001,Tempo/Vans (Private),310,70,380
ANDHRA PRADESH,2001,Jeep (Government),31,9,40
ANDHRA PRADESH,2001,Jeep (Private),473,111,584
ANDHRA PRADESH,2001,Car (Government),18,0,18
ANDHRA PRADESH,2001,Car (Private),426,125,551
ANDHRA PRADESH,2001,Three Wheeler,473,138,611
ANDHRA PRADESH,2001,Two Wheeler,775,94,869
ANDHRA PRADESH,2001,Bicycle,169,12,181
ANDHRA PRADESH,2001,Pedestrian,307,67,374
ANDHRA PRADESH,2001,Others (Please Specify),901,163,1064
ANDHRA PRADESH,2001,Total Deaths (Persons),6947,1427,8374
ANDHRA PRADESH,2001,Total Truck/Lorry,2274,440,2714
ANDHRA PRADESH,2001,Total Bus,777,195,972
ANDHRA PRADESH,2001,Total Tempo/Vans,323,73,396
ANDHRA PRADESH,2001,Total Jeep,504,120,624
ANDHRA PRADESH,2001,Total Car,444,125,569
ANDHRA PRADESH,2002,Truck/Lorry (Government),42,8,50
ANDHRA PRADESH,2002,Truck/Lorry (Private),2664,425,3089
ANDHRA PRADESH,2002,Bus (Government),595,146,741
ANDHRA PRADESH,2002,Bus (Private),294,67,361
ANDHRA PRADESH,2002,Tempo/Vans (Government),35,11,46
ANDHRA PRADESH,2002,Tempo/Vans (Private),413,58,471
ANDHRA PRADESH,2002,Jeep (Government),34,1,35
ANDHRA PRADESH,2002,Jeep (Private),416,97,513
ANDHRA PRADESH,2002,Car (Government),23,4,27
ANDHRA PRADESH,2002,Car (Private),341,101,442
ANDHRA PRADESH,2002,Three Wheeler,724,188,912
ANDHRA PRADESH,2002,Two Wheeler,871,138,1009
ANDHRA PRADESH,2002,Bicycle,160,15,175
ANDHRA PRADESH,2002,Pedestrian,493,90,583
ANDHRA PRADESH,2002,Others (Please Specify),729,168,897
ANDHRA PRADESH,2002,Total Deaths (Persons),7834,1517,9351
ANDHRA PRADESH,2002,Total Truck/Lorry,2706,433,3139
ANDHRA PRADESH,2002,Total Bus,889,213,1102
ANDHRA PRADESH,2002,Total Tempo/Vans,448,69,517
ANDHRA PRADESH,2002,Total Jeep,450,98,548
ANDHRA PRADESH,2002,Total Car,364,105,469
ANDHRA PRADESH,2003,Truck/Lorry (Government),14,1,15
ANDHRA PRADESH,2003,Truck/Lorry (Private),2542,476,3018
ANDHRA PRADESH,2003,Bus (Government),468,169,637
ANDHRA PRADESH,2003,Bus (Private),376,92,468
ANDHRA PRADESH,2003,Tempo/Vans (Government),6,0,6
ANDHRA PRADESH,2003,Tempo/Vans (Private),334,81,415
ANDHRA PRADESH,2003,Jeep (Government),23,7,30
ANDHRA PRADESH,2003,Jeep (Private),536,165,701
ANDHRA PRADESH,2003,Car (Government),10,1,11
ANDHRA PRADESH,2003,Car (Private),487,147,634
ANDHRA PRADESH,2003,Three Wheeler,727,240,967
ANDHRA PRADESH,2003,Two Wheeler,1139,212,1351
ANDHRA PRADESH,2003,Bicycle,156,12,168
ANDHRA PRADESH,2003,Pedestrian,455,140,595
ANDHRA PRADESH,2003,Others (Please Specify),888,264,1152
ANDHRA PRADESH,2003,Total Deaths (Persons),8161,2007,10168
ANDHRA PRADESH,2003,Total Truck/Lorry,2556,477,3033
ANDHRA PRADESH,2003,Total Bus,844,261,1105
ANDHRA PRADESH,2003,Total Tempo/Vans,340,81,421
ANDHRA PRADESH,2003,Total Jeep,559,172,731
ANDHRA PRADESH,2003,Total Car,497,148,645
ANDHRA PRADESH,2004,Truck/Lorry (Government),15,3,18
ANDHRA PRADESH,2004,Truck/Lorry (Private),2687,448,3135
ANDHRA PRADESH,2004,Bus (Government),597,116,713
ANDHRA PRADESH,2004,Bus (Private),253,52,305
ANDHRA PRADESH,2004,Tempo/Vans (Government),21,4,25
ANDHRA PRADESH,2004,Tempo/Vans (Private),500,100,600
ANDHRA PRADESH,2004,Jeep (Government),31,8,39
ANDHRA PRADESH,2004,Jeep (Private),547,121,668
ANDHRA PRADESH,2004,Car (Government),11,5,16
ANDHRA PRADESH,2004,Car (Private),441,119,560
ANDHRA PRADESH,2004,Three Wheeler,1250,280,1530
ANDHRA PRADESH,2004,Two Wheeler,1370,168,1538
ANDHRA PRADESH,2004,Bicycle,130,10,140
ANDHRA PRADESH,2004,Pedestrian,317,80,397
ANDHRA PRADESH,2004,Others (Please Specify),1097,179,1276
ANDHRA PRADESH,2004,Total Deaths (Persons),9267,1693,10960
ANDHRA PRADESH,2004,Total Truck/Lorry,2702,451,3153
ANDHRA PRADESH,2004,Total Bus,850,168,1018
ANDHRA PRADESH,2004,Total Tempo/Vans,521,104,625
ANDHRA PRADESH,2004,Total Jeep,578,129,707
ANDHRA PRADESH,2004,Total Car,452,124,576
ANDHRA PRADESH,2005,Truck/Lorry (Government),35,11,46
ANDHRA PRADESH,2005,Truck/Lorry (Private),2568,594,3162
ANDHRA PRADESH,2005,Bus (Government),536,126,662
ANDHRA PRADESH,2005,Bus (Private),277,101,378
ANDHRA PRADESH,2005,Tempo/Vans (Government),6,1,7
ANDHRA PRADESH,2005,Tempo/Vans (Private),410,96,506
ANDHRA PRADESH,2005,Jeep (Government),73,6,79
ANDHRA PRADESH,2005,Jeep (Private),435,101,536
ANDHRA PRADESH,2005,Car (Government),5,0,5
ANDHRA PRADESH,2005,Car (Private),465,113,578
ANDHRA PRADESH,2005,Three Wheeler,1042,320,1362
ANDHRA PRADESH,2005,Two Wheeler,1184,203,1387
ANDHRA PRADESH,2005,Bicycle,178,9,187
ANDHRA PRADESH,2005,Pedestrian,470,107,577
ANDHRA PRADESH,2005,Others (Please Specify),1196,276,1472
ANDHRA PRADESH,2005,Total Deaths (Persons),8880,2064,10944
ANDHRA PRADESH,2005,Total Truck/Lorry,2603,605,3208
ANDHRA PRADESH,2005,Total Bus,813,227,1040
ANDHRA PRADESH,2005,Total Tempo/Vans,416,97,513
ANDHRA PRADESH,2005,Total Jeep,508,107,615
ANDHRA PRADESH,2005,Total Car,470,113,583
ANDHRA PRADESH,2006,Truck/Lorry (Government),48,17,65
ANDHRA PRADESH,2006,Truck/Lorry (Private),2765,481,3246
ANDHRA PRADESH,2006,Bus (Government),598,152,750
ANDHRA PRADESH,2006,Bus (Private),428,131,559
ANDHRA PRADESH,2006,Tempo/Vans (Government),10,3,13
ANDHRA PRADESH,2006,Tempo/Vans (Private),380,99,479
ANDHRA PRADESH,2006,Jeep (Government),17,5,22
ANDHRA PRADESH,2006,Jeep (Private),454,131,585
ANDHRA PRADESH,2006,Car (Government),4,1,5
ANDHRA PRADESH,2006,Car (Private),638,120,758
ANDHRA PRADESH,2006,Three Wheeler,1439,399,1838
ANDHRA PRADESH,2006,Two Wheeler,1591,299,1890
ANDHRA PRADESH,2006,Bicycle,161,19,180
ANDHRA PRADESH,2006,Pedestrian,514,162,676
ANDHRA PRADESH,2006,Others (Please Specify),1339,256,1595
ANDHRA PRADESH,2006,Total Deaths (Persons),10386,2275,12661
ANDHRA PRADESH,2006,Total Truck/Lorry,2813,498,3311
ANDHRA PRADESH,2006,Total Bus,1026,283,1309
ANDHRA PRADESH,2006,Total Tempo/Vans,390,102,492
ANDHRA PRADESH,2006,Total Jeep,471,136,607
ANDHRA PRADESH,2006,Total Car,642,121,763
ANDHRA PRADESH,2007,Truck/Lorry (Government),139,9,148
ANDHRA PRADESH,2007,Truck/Lorry (Private),2610,558,3168
ANDHRA PRADESH,2007,Bus (Government),678,145,823
ANDHRA PRADESH,2007,Bus (Private),359,96,455
ANDHRA PRADESH,2007,Tempo/Vans (Government),11,4,15
ANDHRA PRADESH,2007,Tempo/Vans (Private),412,78,490
ANDHRA PRADESH,2007,Jeep (Government),17,10,27
ANDHRA PRADESH,2007,Jeep (Private),513,116,629
ANDHRA PRADESH,2007,Car (Government),6,3,9
ANDHRA PRADESH,2007,Car (Private),734,142,876
ANDHRA PRADESH,2007,Three Wheeler,1708,346,2054
ANDHRA PRADESH,2007,Two Wheeler,1859,361,2220
ANDHRA PRADESH,2007,Bicycle,298,48,346
ANDHRA PRADESH,2007,Pedestrian,675,189,864
ANDHRA PRADESH,2007,Others (Please Specify),1385,253,1638
ANDHRA PRADESH,2007,Total Deaths (Persons),11404,2358,13762
ANDHRA PRADESH,2007,Total Truck/Lorry,2749,567,3316
ANDHRA PRADESH,2007,Total Bus,1037,241,1278
ANDHRA PRADESH,2007,Total Tempo/Vans,423,82,505
ANDHRA PRADESH,2007,Total Jeep,530,126,656
ANDHRA PRADESH,2007,Total Car,740,145,885
ANDHRA PRADESH,2008,Truck/Lorry (Government),38,4,42
ANDHRA PRADESH,2008,Truck/Lorry (Private),2792,531,3323
ANDHRA PRADESH,2008,Bus (Government),598,149,747
ANDHRA PRADESH,2008,Bus (Private),446,157,603
ANDHRA PRADESH,2008,Tempo/Vans (Government),20,4,24
ANDHRA PRADESH,2008,Tempo/Vans (Private),506,99,605
ANDHRA PRADESH,2008,Jeep (Government),14,5,19
ANDHRA PRADESH,2008,Jeep (Private),567,189,756
ANDHRA PRADESH,2008,Car (Government),7,2,9
ANDHRA PRADESH,2008,Car (Private),866,227,1093
ANDHRA PRADESH,2008,Three Wheeler,1523,379,1902
ANDHRA PRADESH,2008,Two Wheeler,1888,259,2147
ANDHRA PRADESH,2008,Bicycle,240,27,267
ANDHRA PRADESH,2008,Pedestrian,622,120,742
ANDHRA PRADESH,2008,Others (Please Specify),1657,222,1879
ANDHRA PRADESH,2008,Total Deaths (Persons),11784,2374,14158
ANDHRA PRADESH,2008,Total Truck/Lorry,2830,535,3365
ANDHRA PRADESH,2008,Total Bus,1044,306,1350
ANDHRA PRADESH,2008,Total Tempo/Vans,526,103,629
ANDHRA PRADESH,2008,Total Jeep,581,194,775
ANDHRA PRADESH,2008,Total Car,873,229,1102
ANDHRA PRADESH,2009,Truck/Lorry (Government),19,12,31
ANDHRA PRADESH,2009,Truck/Lorry (Private),2585,504,3089
ANDHRA PRADESH,2009,Bus (Government),447,140,587
ANDHRA PRADESH,2009,Bus (Private),585,180,765
ANDHRA PRADESH,2009,Tempo/Vans (Government),112,48,160
ANDHRA PRADESH,2009,Tempo/Vans (Private),701,144,845
ANDHRA PRADESH,2009,Jeep (Government),9,1,10
ANDHRA PRADESH,2009,Jeep (Private),456,102,558
ANDHRA PRADESH,2009,Car (Government),10,0,10
ANDHRA PRADESH,2009,Car (Private),741,151,892
ANDHRA PRADESH,2009,Three Wheeler,1637,373,2010
ANDHRA PRADESH,2009,Two Wheeler,1878,309,2187
ANDHRA PRADESH,2009,Bicycle,165,6,171
ANDHRA PRADESH,2009,Pedestrian,394,114,508
ANDHRA PRADESH,2009,Others (Please Specify),2327,366,2693
ANDHRA PRADESH,2009,Total Deaths (Persons),12066,2450,14516
ANDHRA PRADESH,2009,Total Truck/Lorry,2604,516,3120
ANDHRA PRADESH,2009,Total Bus,1032,320,1352
ANDHRA PRADESH,2009,Total Tempo/Vans,813,192,1005
ANDHRA PRADESH,2009,Total Jeep,465,103,568
ANDHRA PRADESH,2009,Total Car,751,151,902
ANDHRA PRADESH,2010,Truck/Lorry (Government),58,18,76
ANDHRA PRADESH,2010,Truck/Lorry (Private),2937,440,3377
ANDHRA PRADESH,2010,Bus (Government),741,146,887
ANDHRA PRADESH,2010,Bus (Private),501,152,653
ANDHRA PRADESH,2010,Tempo/Vans (Government),7,1,8
ANDHRA PRADESH,2010,Tempo/Vans (Private),740,120,860
ANDHRA PRADESH,2010,Jeep (Government),23,5,28
ANDHRA PRADESH,2010,Jeep (Private),643,191,834
ANDHRA PRADESH,2010,Car (Government),50,6,56
ANDHRA PRADESH,2010,Car (Private),995,218,1213
ANDHRA PRADESH,2010,Three Wheeler,1882,383,2265
ANDHRA PRADESH,2010,Two Wheeler,2222,357,2579
ANDHRA PRADESH,2010,Bicycle,183,12,195
ANDHRA PRADESH,2010,Pedestrian,422,97,519
ANDHRA PRADESH,2010,Others (Please Specify),1487,300,1787
ANDHRA PRADESH,2010,Total Deaths (Persons),12891,2446,15337
ANDHRA PRADESH,2010,Total Truck/Lorry,2995,458,3453
ANDHRA PRADESH,2010,Total Bus,1242,298,1540
ANDHRA PRADESH,2010,Total Tempo/Vans,747,121,868
ANDHRA PRADESH,2010,Total Jeep,666,196,862
ANDHRA PRADESH,2010,Total Car,1045,224,1269
ANDHRA PRADESH,2011,Truck/Lorry (Government),18,3,21
ANDHRA PRADESH,2011,Truck/Lorry (Private),3110,471,3581
ANDHRA PRADESH,2011,Bus (Government),577,127,704
ANDHRA PRADESH,2011,Bus (Private),376,114,490
ANDHRA PRADESH,2011,Tempo/Vans (Government),85,1,86
ANDHRA PRADESH,2011,Tempo/Vans (Private),752,159,911
ANDHRA PRADESH,2011,Jeep (Government),13,3,16
ANDHRA PRADESH,2011,Jeep (Private),627,198,825
ANDHRA PRADESH,2011,Car (Government),10,4,14
ANDHRA PRADESH,2011,Car (Private),907,238,1145
ANDHRA PRADESH,2011,Three Wheeler,1485,397,1882
ANDHRA PRADESH,2011,Two Wheeler,2489,482,2971
ANDHRA PRADESH,2011,Bicycle,131,6,137
ANDHRA PRADESH,2011,Pedestrian,422,101,523
ANDHRA PRADESH,2011,Others (Please Specify),1526,326,1852
ANDHRA PRADESH,2011,Total Deaths (Persons),12528,2630,15158
ANDHRA PRADESH,2011,Total Truck/Lorry,3128,474,3602
ANDHRA PRADESH,2011,Total Bus,953,241,1194
ANDHRA PRADESH,2011,Total Tempo/Vans,837,160,997
ANDHRA PRADESH,2011,Total Jeep,640,201,841
ANDHRA PRADESH,2011,Total Car,917,242,1159
ANDHRA PRADESH,2012,Truck/Lorry (Government),26,7,33
ANDHRA PRADESH,2012,Truck/Lorry (Private),2999,400,3399
ANDHRA PRADESH,2012,Bus (Government),689,142,831
ANDHRA PRADESH,2012,Bus (Private),447,96,543
ANDHRA PRADESH,2012,Tempo/Vans (Government),19,3,22
ANDHRA PRADESH,2012,Tempo/Vans (Private),575,106,681
ANDHRA PRADESH,2012,Jeep (Government),4,0,4
ANDHRA PRADESH,2012,Jeep (Private),475,138,613
ANDHRA PRADESH,2012,Car (Government),35,3,38
ANDHRA PRADESH,2012,Car (Private),1125,175,1300
ANDHRA PRADESH,2012,Three Wheeler,1333,401,1734
ANDHRA PRADESH,2012,Two Wheeler,2357,344,2701
ANDHRA PRADESH,2012,Bicycle,173,8,181
ANDHRA PRADESH,2012,Pedestrian,590,105,695
ANDHRA PRADESH,2012,Others (Please Specify),1896,295,2191
ANDHRA PRADESH,2012,Total Deaths (Persons),12743,2223,14966
ANDHRA PRADESH,2012,Total Truck/Lorry,3025,407,3432
ANDHRA PRADESH,2012,Total Bus,1136,238,1374
ANDHRA PRADESH,2012,Total Tempo/Vans,594,109,703
ANDHRA PRADESH,2012,Total Jeep,479,138,617
ANDHRA PRADESH,2012,Total Car,1160,178,1338
ARUNACHAL PRADESH,2001,Truck/Lorry (Government),2,0,2
ARUNACHAL PRADESH,2001,Truck/Lorry (Private),27,6,33
ARUNACHAL PRADESH,2001,Bus (Government),0,0,0
ARUNACHAL PRADESH,2001,Bus (Private),8,0,8
ARUNACHAL PRADESH,2001,Tempo/Vans (Government),0,4,4
ARUNACHAL PRADESH,2001,Tempo/Vans (Private),0,0,0
ARUNACHAL PRADESH,2001,Jeep (Government),0,0,0
ARUNACHAL PRADESH,2001,Jeep (Private),4,0,4
ARUNACHAL PRADESH,2001,Car (Government),0,0,0
ARUNACHAL PRADESH,2001,Car (Private),0,0,0
ARUNACHAL PRADESH,2001,Three Wheeler,0,0,0
ARUNACHAL PRADESH,2001,Two Wheeler,7,1,8
ARUNACHAL PRADESH,2001,Bicycle,0,0,0
ARUNACHAL PRADESH,2001,Pedestrian,1,0,1
ARUNACHAL PRADESH,2001,Others (Please Specify),0,0,0
ARUNACHAL PRADESH,2001,Total Deaths (Persons),49,11,60
ARUNACHAL PRADESH,2001,Total Truck/Lorry,29,6,35
ARUNACHAL PRADESH,2001,Total Bus,8,0,8
ARUNACHAL PRADESH,2001,Total Tempo/Vans,0,4,4
ARUNACHAL PRADESH,2001,Total Jeep,4,0,4
ARUNACHAL PRADESH,2001,Total Car,0,0,0
ARUNACHAL PRADESH,2002,Truck/Lorry (Government),2,1,3
ARUNACHAL PRADESH,2002,Truck/Lorry (Private),59,12,71
ARUNACHAL PRADESH,2002,Bus (Government),2,1,3
ARUNACHAL PRADESH,2002,Bus (Private),2,1,3
ARUNACHAL PRADESH,2002,Tempo/Vans (Government),0,0,0
ARUNACHAL PRADESH,2002,Tempo/Vans (Private),2,0,2
ARUNACHAL PRADESH,2002,Jeep (Government),1,1,2
ARUNACHAL PRADESH,2002,Jeep (Private),11,2,13
ARUNACHAL PRADESH,2002,Car (Government),0,0,0
ARUNACHAL PRADESH,2002,Car (Private),0,0,0
ARUNACHAL PRADESH,2002,Three Wheeler,1,0,1
ARUNACHAL PRADESH,2002,Two Wheeler,14,2,16
ARUNACHAL PRADESH,2002,Bicycle,0,0,0
ARUNACHAL PRADESH,2002,Pedestrian,0,0,0
ARUNACHAL PRADESH,2002,Others (Please Specify),0,0,0
ARUNACHAL PRADESH,2002,Total Deaths (Persons),94,20,114
ARUNACHAL PRADESH,2002,Total Truck/Lorry,61,13,74
ARUNACHAL PRADESH,2002,Total Bus,4,2,6
ARUNACHAL PRADESH,2002,Total Tempo/Vans,2,0,2
ARUNACHAL PRADESH,2002,Total Jeep,12,3,15
ARUNACHAL PRADESH,2002,Total Car,0,0,0
ARUNACHAL PRADESH,2003,Truck/Lorry (Government),7,2,9
ARUNACHAL PRADESH,2003,Truck/Lorry (Private),40,6,46
ARUNACHAL PRADESH,2003,Bus (Government),8,11,19
ARUNACHAL PRADESH,2003,Bus (Private),23,2,25
ARUNACHAL PRADESH,2003,Tempo/Vans (Government),0,0,0
ARUNACHAL PRADESH,2003,Tempo/Vans (Private),3,0,3
ARUNACHAL PRADESH,2003,Jeep (Government),0,0,0
ARUNACHAL PRADESH,2003,Jeep (Private),13,2,15
ARUNACHAL PRADESH,2003,Car (Government),0,0,0
ARUNACHAL PRADESH,2003,Car (Private),0,0,0
ARUNACHAL PRADESH,2003,Three Wheeler,5,0,5
ARUNACHAL PRADESH,2003,Two Wheeler,11,1,12
ARUNACHAL PRADESH,2003,Bicycle,1,0,1
ARUNACHAL PRADESH,2003,Pedestrian,0,0,0
ARUNACHAL PRADESH,2003,Others (Please Specify),0,0,0
ARUNACHAL PRADESH,2003,Total Deaths (Persons),111,24,135
ARUNACHAL PRADESH,2003,Total Truck/Lorry,47,8,55
ARUNACHAL PRADESH,2003,Total Bus,31,13,44
ARUNACHAL PRADESH,2003,Total Tempo/Vans,3,0,3
ARUNACHAL PRADESH,2003,Total Jeep,13,2,15
ARUNACHAL PRADESH,2003,Total Car,0,0,0
ARUNACHAL PRADESH,2004,Truck/Lorry (Government),12,0,12
ARUNACHAL PRADESH,2004,Truck/Lorry (Private),36,3,39
ARUNACHAL PRADESH,2004,Bus (Government),0,0,0
ARUNACHAL PRADESH,2004,Bus (Private),55,22,77
ARUNACHAL PRADESH,2004,Tempo/Vans (Government),0,0,0
ARUNACHAL PRADESH,2004,Tempo/Vans (Private),7,0,7
ARUNACHAL PRADESH,2004,Jeep (Government),0,0,0
ARUNACHAL PRADESH,2004,Jeep (Private),3,2,5
ARUNACHAL PRADESH,2004,Car (Government),0,0,0
ARUNACHAL PRADESH,2004,Car (Private),4,1,5
ARUNACHAL PRADESH,2004,Three Wheeler,6,0,6
ARUNACHAL PRADESH,2004,Two Wheeler,18,5,23
ARUNACHAL PRADESH,2004,Bicycle,1,0,1
ARUNACHAL PRADESH,2004,Pedestrian,5,1,6
ARUNACHAL PRADESH,2004,Others (Please Specify),0,0,0
ARUNACHAL PRADESH,2004,Total Deaths (Persons),147,34,181
ARUNACHAL PRADESH,2004,Total Truck/Lorry,48,3,51
ARUNACHAL PRADESH,2004,Total Bus,55,22,77
ARUNACHAL PRADESH,2004,Total Tempo/Vans,7,0,7
ARUNACHAL PRADESH,2004,Total Jeep,3,2,5
ARUNACHAL PRADESH,2004,Total Car,4,1,5
ARUNACHAL PRADESH,2005,Truck/Lorry (Government),11,1,12
ARUNACHAL PRADESH,2005,Truck/Lorry (Private),33,2,35
ARUNACHAL PRADESH,2005,Bus (Government),0,1,1
ARUNACHAL PRADESH,2005,Bus (Private),4,1,5
ARUNACHAL PRADESH,2005,Tempo/Vans (Government),0,0,0
ARUNACHAL PRADESH,2005,Tempo/Vans (Private),7,2,9
ARUNACHAL PRADESH,2005,Jeep (Government),2,0,2
ARUNACHAL PRADESH,2005,Jeep (Private),6,1,7
ARUNACHAL PRADESH,2005,Car (Government),0,0,0
ARUNACHAL PRADESH,2005,Car (Private),2,0,2
ARUNACHAL PRADESH,2005,Three Wheeler,2,1,3
ARUNACHAL PRADESH,2005,Two Wheeler,11,0,11
ARUNACHAL PRADESH,2005,Bicycle,0,0,0
ARUNACHAL PRADESH,2005,Pedestrian,1,1,2
ARUNACHAL PRADESH,2005,Others (Please Specify),0,0,0
ARUNACHAL PRADESH,2005,Total Deaths (Persons),79,10,89
ARUNACHAL PRADESH,2005,Total Truck/Lorry,44,3,47
ARUNACHAL PRADESH,2005,Total Bus,4,2,6
ARUNACHAL PRADESH,2005,Total Tempo/Vans,7,2,9
ARUNACHAL PRADESH,2005,Total Jeep,8,1,9
ARUNACHAL PRADESH,2005,Total Car,2,0,2
ARUNACHAL PRADESH,2006,Truck/Lorry (Government),21,2,23
ARUNACHAL PRADESH,2006,Truck/Lorry (Private),23,1,24
ARUNACHAL PRADESH,2006,Bus (Government),0,0,0
ARUNACHAL PRADESH,2006,Bus (Private),4,1,5
ARUNACHAL PRADESH,2006,Tempo/Vans (Government),3,0,3
ARUNACHAL PRADESH,2006,Tempo/Vans (Private),0,0,0
ARUNACHAL PRADESH,2006,Jeep (Government),6,1,7
ARUNACHAL PRADESH,2006,Jeep (Private),11,0,11
ARUNACHAL PRADESH,2006,Car (Government),2,1,3
ARUNACHAL PRADESH,2006,Car (Private),1,0,1
ARUNACHAL PRADESH,2006,Three Wheeler,0,0,0
ARUNACHAL PRADESH,2006,Two Wheeler,38,0,38
ARUNACHAL PRADESH,2006,Bicycle,0,0,0
ARUNACHAL PRADESH,2006,Pedestrian,0,0,0
ARUNACHAL PRADESH,2006,Others (Please Specify),1,0,1
ARUNACHAL PRADESH,2006,Total Deaths (Persons),110,6,116
ARUNACHAL PRADESH,2006,Total Truck/Lorry,44,3,47
ARUNACHAL PRADESH,2006,Total Bus,4,1,5
ARUNACHAL PRADESH,2006,Total Tempo/Vans,3,0,3
ARUNACHAL PRADESH,2006,Total Jeep,17,1,18
ARUNACHAL PRADESH,2006,Total Car,3,1,4
ARUNACHAL PRADESH,2007,Truck/Lorry (Government),12,2,14
ARUNACHAL PRADESH,2007,Truck/Lorry (Private),27,4,31
ARUNACHAL PRADESH,2007,Bus (Government),1,1,2
ARUNACHAL PRADESH,2007,Bus (Private),4,0,4
ARUNACHAL PRADESH,2007,Tempo/Vans (Government),0,0,0
ARUNACHAL PRADESH,2007,Tempo/Vans (Private),0,0,0
ARUNACHAL PRADESH,2007,Jeep (Government),5,2,7
ARUNACHAL PRADESH,2007,Jeep (Private),6,1,7
ARUNACHAL PRADESH,2007,Car (Government),0,0,0
ARUNACHAL PRADESH,2007,Car (Private),15,0,15
ARUNACHAL PRADESH,2007,Three Wheeler,2,0,2
ARUNACHAL PRADESH,2007,Two Wheeler,16,4,20
ARUNACHAL PRADESH,2007,Bicycle,1,0,1
ARUNACHAL PRADESH,2007,Pedestrian,0,0,0
ARUNACHAL PRADESH,2007,Others (Please Specify),5,0,5
ARUNACHAL PRADESH,2007,Total Deaths (Persons),94,14,108
ARUNACHAL PRADESH,2007,Total Truck/Lorry,39,6,45
ARUNACHAL PRADESH,2007,Total Bus,5,1,6
ARUNACHAL PRADESH,2007,Total Tempo/Vans,0,0,0
ARUNACHAL PRADESH,2007,Total Jeep,11,3,14
ARUNACHAL PRADESH,2007,Total Car,15,0,15
ARUNACHAL PRADESH,2008,Truck/Lorry (Government),3,0,3
ARUNACHAL PRADESH,2008,Truck/Lorry (Private),49,2,51
ARUNACHAL PRADESH,2008,Bus (Government),7,1,8
ARUNACHAL PRADESH,2008,Bus (Private),6,1,7
ARUNACHAL PRADESH,2008,Tempo/Vans (Government),0,0,0
ARUNACHAL PRADESH,2008,Tempo/Vans (Private),0,0,0
ARUNACHAL PRADESH,2008,Jeep (Government),1,1,2
ARUNACHAL PRADESH,2008,Jeep (Private),9,8,17
ARUNACHAL PRADESH,2008,Car (Government),0,0,0
ARUNACHAL PRADESH,2008,Car (Private),3,4,7
ARUNACHAL PRADESH,2008,Three Wheeler,1,3,4
ARUNACHAL PRADESH,2008,Two Wheeler,20,1,21
ARUNACHAL PRADESH,2008,Bicycle,0,0,0
ARUNACHAL PRADESH,2008,Pedestrian,3,2,5
ARUNACHAL PRADESH,2008,Others (Please Specify),0,0,0
ARUNACHAL PRADESH,2008,Total Deaths (Persons),102,23,125
ARUNACHAL PRADESH,2008,Total Truck/Lorry,52,2,54
ARUNACHAL PRADESH,2008,Total Bus,13,2,15
ARUNACHAL PRADESH,2008,Total Tempo/Vans,0,0,0
ARUNACHAL PRADESH,2008,Total Jeep,10,9,19
ARUNACHAL PRADESH,2008,Total Car,3,4,7
ARUNACHAL PRADESH,2009,Truck/Lorry (Government),3,0,3
ARUNACHAL PRADESH,2009,Truck/Lorry (Private),49,2,51
ARUNACHAL PRADESH,2009,Bus (Government),7,1,8
ARUNACHAL PRADESH,2009,Bus (Private),6,1,7
ARUNACHAL PRADESH,2009,Tempo/Vans (Government),0,0,0
ARUNACHAL PRADESH,2009,Tempo/Vans (Private),0,0,0
ARUNACHAL PRADESH,2009,Jeep (Government),1,1,2
ARUNACHAL PRADESH,2009,Jeep (Private),9,8,17
ARUNACHAL PRADESH,2009,Car (Government),0,0,0
ARUNACHAL PRADESH,2009,Car (Private),3,4,7
ARUNACHAL PRADESH,2009,Three Wheeler,1,3,4
ARUNACHAL PRADESH,2009,Two Wheeler,20,1,21
ARUNACHAL PRADESH,2009,Bicycle,0,0,0
ARUNACHAL PRADESH,2009,Pedestrian,3,2,5
ARUNACHAL PRADESH,2009,Others (Please Specify),0,0,0
ARUNACHAL PRADESH,2009,Total Deaths (Persons),102,23,125
ARUNACHAL PRADESH,2009,Total Truck/Lorry,52,2,54
ARUNACHAL PRADESH,2009,Total Bus,13,2,15
ARUNACHAL PRADESH,2009,Total Tempo/Vans,0,0,0
ARUNACHAL PRADESH,2009,Total Jeep,10,9,19
ARUNACHAL PRADESH,2009,Total Car,3,4,7
ARUNACHAL PRADESH,2010,Truck/Lorry (Government),16,1,17
ARUNACHAL PRADESH,2010,Truck/Lorry (Private),36,4,40
ARUNACHAL PRADESH,2010,Bus (Government),3,0,3
ARUNACHAL PRADESH,2010,Bus (Private),2,0,2
ARUNACHAL PRADESH,2010,Tempo/Vans (Government),1,0,1
ARUNACHAL PRADESH,2010,Tempo/Vans (Private),1,0,1
ARUNACHAL PRADESH,2010,Jeep (Government),0,0,0
ARUNACHAL PRADESH,2010,Jeep (Private),6,3,9
ARUNACHAL PRADESH,2010,Car (Government),1,0,1
ARUNACHAL PRADESH,2010,Car (Private),9,1,10
ARUNACHAL PRADESH,2010,Three Wheeler,4,2,6
ARUNACHAL PRADESH,2010,Two Wheeler,28,6,34
ARUNACHAL PRADESH,2010,Bicycle,1,0,1
ARUNACHAL PRADESH,2010,Pedestrian,3,1,4
ARUNACHAL PRADESH,2010,Others (Please Specify),9,1,10
ARUNACHAL PRADESH,2010,Total Deaths (Persons),120,19,139
ARUNACHAL PRADESH,2010,Total Truck/Lorry,52,5,57
ARUNACHAL PRADESH,2010,Total Bus,5,0,5
ARUNACHAL PRADESH,2010,Total Tempo/Vans,2,0,2
ARUNACHAL PRADESH,2010,Total Jeep,6,3,9
ARUNACHAL PRADESH,2010,Total Car,10,1,11
ARUNACHAL PRADESH,2011,Truck/Lorry (Government),5,0,5
ARUNACHAL PRADESH,2011,Truck/Lorry (Private),26,5,31
ARUNACHAL PRADESH,2011,Bus (Government),1,1,2
ARUNACHAL PRADESH,2011,Bus (Private),3,1,4
ARUNACHAL PRADESH,2011,Tempo/Vans (Government),0,0,0
ARUNACHAL PRADESH,2011,Tempo/Vans (Private),4,0,4
ARUNACHAL PRADESH,2011,Jeep (Government),5,0,5
ARUNACHAL PRADESH,2011,Jeep (Private),1,3,4
ARUNACHAL PRADESH,2011,Car (Government),3,0,3
ARUNACHAL PRADESH,2011,Car (Private),19,5,24
ARUNACHAL PRADESH,2011,Three Wheeler,1,0,1
ARUNACHAL PRADESH,2011,Two Wheeler,31,9,40
ARUNACHAL PRADESH,2011,Bicycle,0,0,0
ARUNACHAL PRADESH,2011,Pedestrian,0,0,0
ARUNACHAL PRADESH,2011,Others (Please Specify),3,0,3
ARUNACHAL PRADESH,2011,Total Deaths (Persons),102,24,126
ARUNACHAL PRADESH,2011,Total Truck/Lorry,31,5,36
ARUNACHAL PRADESH,2011,Total Bus,4,2,6
ARUNACHAL PRADESH,2011,Total Tempo/Vans,4,0,4
ARUNACHAL PRADESH,2011,Total Jeep,6,3,9
ARUNACHAL PRADESH,2011,Total Car,22,5,27
ARUNACHAL PRADESH,2012,Truck/Lorry (Government),3,0,3
ARUNACHAL PRADESH,2012,Truck/Lorry (Private),20,6,26
ARUNACHAL PRADESH,2012,Bus (Government),2,0,2
ARUNACHAL PRADESH,2012,Bus (Private),4,0,4
ARUNACHAL PRADESH,2012,Tempo/Vans (Government),0,0,0
ARUNACHAL PRADESH,2012,Tempo/Vans (Private),3,0,3
ARUNACHAL PRADESH,2012,Jeep (Government),1,0,1
ARUNACHAL PRADESH,2012,Jeep (Private),12,3,15
ARUNACHAL PRADESH,2012,Car (Government),0,0,0
ARUNACHAL PRADESH,2012,Car (Private),11,2,13
ARUNACHAL PRADESH,2012,Three Wheeler,7,1,8
ARUNACHAL PRADESH,2012,Two Wheeler,31,10,41
ARUNACHAL PRADESH,2012,Bicycle,0,0,0
ARUNACHAL PRADESH,2012,Pedestrian,18,2,20
ARUNACHAL PRADESH,2012,Others (Please Specify),0,0,0
ARUNACHAL PRADESH,2012,Total Deaths (Persons),112,24,136
ARUNACHAL PRADESH,2012,Total Truck/Lorry,23,6,29
ARUNACHAL PRADESH,2012,Total Bus,6,0,6
ARUNACHAL PRADESH,2012,Total Tempo/Vans,3,0,3
ARUNACHAL PRADESH,2012,Total Jeep,13,3,16
ARUNACHAL PRADESH,2012,Total Car,11,2,13
ASSAM,2001,Truck/Lorry (Government),2,0,2
ASSAM,2001,Truck/Lorry (Private),173,19,192
ASSAM,2001,Bus (Government),2,1,3
ASSAM,2001,Bus (Private),231,66,297
ASSAM,2001,Tempo/Vans (Government),3,0,3
ASSAM,2001,Tempo/Vans (Private),8,1,9
ASSAM,2001,Jeep (Government),1,0,1
ASSAM,2001,Jeep (Private),28,8,36
ASSAM,2001,Car (Government),6,0,6
ASSAM,2001,Car (Private),40,19,59
ASSAM,2001,Three Wheeler,8,0,8
ASSAM,2001,Two Wheeler,29,13,42
ASSAM,2001,Bicycle,27,2,29
ASSAM,2001,Pedestrian,53,18,71
ASSAM,2001,Others (Please Specify),13,5,18
ASSAM,2001,Total Deaths (Persons),624,152,776
ASSAM,2001,Total Truck/Lorry,175,19,194
ASSAM,2001,Total Bus,233,67,300
ASSAM,2001,Total Tempo/Vans,11,1,12
ASSAM,2001,Total Jeep,29,8,37
ASSAM,2001,Total Car,46,19,65
ASSAM,2002,Truck/Lorry (Government),21,4,25
ASSAM,2002,Truck/Lorry (Private),204,36,240
ASSAM,2002,Bus (Government),8,4,12
ASSAM,2002,Bus (Private),220,65,285
ASSAM,2002,Tempo/Vans (Government),7,1,8
ASSAM,2002,Tempo/Vans (Private),16,1,17
ASSAM,2002,Jeep (Government),4,0,4
ASSAM,2002,Jeep (Private),27,3,30
ASSAM,2002,Car (Government),4,0,4
ASSAM,2002,Car (Private),44,14,58
ASSAM,2002,Three Wheeler,28,10,38
ASSAM,2002,Two Wheeler,43,8,51
ASSAM,2002,Bicycle,23,0,23
ASSAM,2002,Pedestrian,59,3,62
ASSAM,2002,Others (Please Specify),46,6,52
ASSAM,2002,Total Deaths (Persons),754,155,909
ASSAM,2002,Total Truck/Lorry,225,40,265
ASSAM,2002,Total Bus,228,69,297
ASSAM,2002,Total Tempo/Vans,23,2,25
ASSAM,2002,Total Jeep,31,3,34
ASSAM,2002,Total Car,48,14,62
ASSAM,2003,Truck/Lorry (Government),9,4,13
ASSAM,2003,Truck/Lorry (Private),256,44,300
ASSAM,2003,Bus (Government),4,5,9
ASSAM,2003,Bus (Private),322,89,411
ASSAM,2003,Tempo/Vans (Government),7,3,10
ASSAM,2003,Tempo/Vans (Private),22,27,49
ASSAM,2003,Jeep (Government),13,10,23
ASSAM,2003,Jeep (Private),19,6,25
ASSAM,2003,Car (Government),5,1,6
ASSAM,2003,Car (Private),38,7,45
ASSAM,2003,Three Wheeler,20,13,33
ASSAM,2003,Two Wheeler,89,18,107
ASSAM,2003,Bicycle,8,0,8
ASSAM,2003,Pedestrian,60,5,65
ASSAM,2003,Others (Please Specify),26,7,33
ASSAM,2003,Total Deaths (Persons),898,239,1137
ASSAM,2003,Total Truck/Lorry,265,48,313
ASSAM,2003,Total Bus,326,94,420
ASSAM,2003,Total Tempo/Vans,29,30,59
ASSAM,2003,Total Jeep,32,16,48
ASSAM,2003,Total Car,43,8,51
ASSAM,2004,Truck/Lorry (Government),6,1,7
ASSAM,2004,Truck/Lorry (Private),206,16,222
ASSAM,2004,Bus (Government),10,1,11
ASSAM,2004,Bus (Private),332,76,408
ASSAM,2004,Tempo/Vans (Government),6,1,7
ASSAM,2004,Tempo/Vans (Private),23,5,28
ASSAM,2004,Jeep (Government),7,1,8
ASSAM,2004,Jeep (Private),41,7,48
ASSAM,2004,Car (Government),6,1,7
ASSAM,2004,Car (Private),54,11,65
ASSAM,2004,Three Wheeler,18,4,22
ASSAM,2004,Two Wheeler,64,15,79
ASSAM,2004,Bicycle,7,2,9
ASSAM,2004,Pedestrian,33,6,39
ASSAM,2004,Others (Please Specify),41,11,52
ASSAM,2004,Total Deaths (Persons),854,158,1012
ASSAM,2004,Total Truck/Lorry,212,17,229
ASSAM,2004,Total Bus,342,77,419
ASSAM,2004,Total Tempo/Vans,29,6,35
ASSAM,2004,Total Jeep,48,8,56
ASSAM,2004,Total Car,60,12,72
ASSAM,2005,Truck/Lorry (Government),0,0,0
ASSAM,2005,Truck/Lorry (Private),258,24,282
ASSAM,2005,Bus (Government),11,2,13
ASSAM,2005,Bus (Private),436,85,521
ASSAM,2005,Tempo/Vans (Government),0,0,0
ASSAM,2005,Tempo/Vans (Private),73,7,80
ASSAM,2005,Jeep (Government),0,0,0
ASSAM,2005,Jeep (Private),85,12,97
ASSAM,2005,Car (Government),1,0,1
ASSAM,2005,Car (Private),106,28,134
ASSAM,2005,Three Wheeler,52,3,55
ASSAM,2005,Two Wheeler,96,20,116
ASSAM,2005,Bicycle,22,6,28
ASSAM,2005,Pedestrian,63,9,72
ASSAM,2005,Others (Please Specify),48,9,57
ASSAM,2005,Total Deaths (Persons),1251,205,1456
ASSAM,2005,Total Truck/Lorry,258,24,282
ASSAM,2005,Total Bus,447,87,534
ASSAM,2005,Total Tempo/Vans,73,7,80
ASSAM,2005,Total Jeep,85,12,97
ASSAM,2005,Total Car,107,28,135
ASSAM,2006,Truck/Lorry (Government),9,0,9
ASSAM,2006,Truck/Lorry (Private),289,40,329
ASSAM,2006,Bus (Government),8,0,8
ASSAM,2006,Bus (Private),459,182,641
ASSAM,2006,Tempo/Vans (Government),6,0,6
ASSAM,2006,Tempo/Vans (Private),74,19,93
ASSAM,2006,Jeep (Government),4,1,5
ASSAM,2006,Jeep (Private),67,14,81
ASSAM,2006,Car (Government),1,0,1
ASSAM,2006,Car (Private),131,35,166
ASSAM,2006,Three Wheeler,37,9,46
ASSAM,2006,Two Wheeler,164,31,195
ASSAM,2006,Bicycle,49,6,55
ASSAM,2006,Pedestrian,74,13,87
ASSAM,2006,Others (Please Specify),17,1,18
ASSAM,2006,Total Deaths (Persons),1389,351,1740
ASSAM,2006,Total Truck/Lorry,298,40,338
ASSAM,2006,Total Bus,467,182,649
ASSAM,2006,Total Tempo/Vans,80,19,99
ASSAM,2006,Total Jeep,71,15,86
ASSAM,2006,Total Car,132,35,167
ASSAM,2007,Truck/Lorry (Government),20,2,22
ASSAM,2007,Truck/Lorry (Private),293,29,322
ASSAM,2007,Bus (Government),7,0,7
ASSAM,2007,Bus (Private),408,73,481
ASSAM,2007,Tempo/Vans (Government),8,0,8
ASSAM,2007,Tempo/Vans (Private),76,6,82
ASSAM,2007,Jeep (Government),3,0,3
ASSAM,2007,Jeep (Private),96,11,107
ASSAM,2007,Car (Government),0,0,0
ASSAM,2007,Car (Private),113,14,127
ASSAM,2007,Three Wheeler,51,6,57
ASSAM,2007,Two Wheeler,155,16,171
ASSAM,2007,Bicycle,72,4,76
ASSAM,2007,Pedestrian,92,15,107
ASSAM,2007,Others (Please Specify),25,9,34
ASSAM,2007,Total Deaths (Persons),1419,185,1604
ASSAM,2007,Total Truck/Lorry,313,31,344
ASSAM,2007,Total Bus,415,73,488
ASSAM,2007,Total Tempo/Vans,84,6,90
ASSAM,2007,Total Jeep,99,11,110
ASSAM,2007,Total Car,113,14,127
ASSAM,2008,Truck/Lorry (Government),1,0,1
ASSAM,2008,Truck/Lorry (Private),327,33,360
ASSAM,2008,Bus (Government),7,1,8
ASSAM,2008,Bus (Private),426,102,528
ASSAM,2008,Tempo/Vans (Government),0,0,0
ASSAM,2008,Tempo/Vans (Private),68,11,79
ASSAM,2008,Jeep (Government),1,0,1
ASSAM,2008,Jeep (Private),48,7,55
ASSAM,2008,Car (Government),2,0,2
ASSAM,2008,Car (Private),93,34,127
ASSAM,2008,Three Wheeler,69,11,80
ASSAM,2008,Two Wheeler,199,37,236
ASSAM,2008,Bicycle,75,7,82
ASSAM,2008,Pedestrian,109,16,125
ASSAM,2008,Others (Please Specify),34,3,37
ASSAM,2008,Total Deaths (Persons),1459,262,1721
ASSAM,2008,Total Truck/Lorry,328,33,361
ASSAM,2008,Total Bus,433,103,536
ASSAM,2008,Total Tempo/Vans,68,11,79
ASSAM,2008,Total Jeep,49,7,56
ASSAM,2008,Total Car,95,34,129
ASSAM,2009,Truck/Lorry (Government),4,1,5
ASSAM,2009,Truck/Lorry (Private),378,44,422
ASSAM,2009,Bus (Government),1,0,1
ASSAM,2009,Bus (Private),420,83,503
ASSAM,2009,Tempo/Vans (Government),3,2,5
ASSAM,2009,Tempo/Vans (Private),103,13,116
ASSAM,2009,Jeep (Government),1,0,1
ASSAM,2009,Jeep (Private),51,20,71
ASSAM,2009,Car (Government),18,4,22
ASSAM,2009,Car (Private),225,29,254
ASSAM,2009,Three Wheeler,73,11,84
ASSAM,2009,Two Wheeler,242,39,281
ASSAM,2009,Bicycle,39,1,40
ASSAM,2009,Pedestrian,100,17,117
ASSAM,2009,Others (Please Specify),51,10,61
ASSAM,2009,Total Deaths (Persons),1709,274,1983
ASSAM,2009,Total Truck/Lorry,382,45,427
ASSAM,2009,Total Bus,421,83,504
ASSAM,2009,Total Tempo/Vans,106,15,121
ASSAM,2009,Total Jeep,52,20,72
ASSAM,2009,Total Car,243,33,276
ASSAM,2010,Truck/Lorry (Government),9,0,9
ASSAM,2010,Truck/Lorry (Private),352,42,394
ASSAM,2010,Bus (Government),7,0,7
ASSAM,2010,Bus (Private),312,76,388
ASSAM,2010,Tempo/Vans (Government),1,0,1
ASSAM,2010,Tempo/Vans (Private),141,26,167
ASSAM,2010,Jeep (Government),3,0,3
ASSAM,2010,Jeep (Private),51,11,62
ASSAM,2010,Car (Government),0,0,0
ASSAM,2010,Car (Private),357,80,437
ASSAM,2010,Three Wheeler,85,20,105
ASSAM,2010,Two Wheeler,246,38,284
ASSAM,2010,Bicycle,63,3,66
ASSAM,2010,Pedestrian,59,5,64
ASSAM,2010,Others (Please Specify),34,9,43
ASSAM,2010,Total Deaths (Persons),1720,310,2030
ASSAM,2010,Total Truck/Lorry,361,42,403
ASSAM,2010,Total Bus,319,76,395
ASSAM,2010,Total Tempo/Vans,142,26,168
ASSAM,2010,Total Jeep,54,11,65
ASSAM,2010,Total Car,357,80,437
ASSAM,2011,Truck/Lorry (Government),0,0,0
ASSAM,2011,Truck/Lorry (Private),528,27,555
ASSAM,2011,Bus (Government),0,0,0
ASSAM,2011,Bus (Private),277,54,331
ASSAM,2011,Tempo/Vans (Government),0,0,0
ASSAM,2011,Tempo/Vans (Private),58,15,73
ASSAM,2011,Jeep (Government),1,0,1
ASSAM,2011,Jeep (Private),38,13,51
ASSAM,2011,Car (Government),0,0,0
ASSAM,2011,Car (Private),491,86,577
ASSAM,2011,Three Wheeler,62,8,70
ASSAM,2011,Two Wheeler,345,41,386
ASSAM,2011,Bicycle,38,2,40
ASSAM,2011,Pedestrian,53,4,57
ASSAM,2011,Others (Please Specify),173,28,201
ASSAM,2011,Total Deaths (Persons),2064,278,2342
ASSAM,2011,Total Truck/Lorry,528,27,555
ASSAM,2011,Total Bus,277,54,331
ASSAM,2011,Total Tempo/Vans,58,15,73
ASSAM,2011,Total Jeep,39,13,52
ASSAM,2011,Total Car,491,86,577
ASSAM,2012,Truck/Lorry (Government),0,0,0
ASSAM,2012,Truck/Lorry (Private),427,28,455
ASSAM,2012,Bus (Government),1,0,1
ASSAM,2012,Bus (Private),202,57,259
ASSAM,2012,Tempo/Vans (Government),0,0,0
ASSAM,2012,Tempo/Vans (Private),74,13,87
ASSAM,2012,Jeep (Government),0,0,0
ASSAM,2012,Jeep (Private),58,6,64
ASSAM,2012,Car (Government),11,0,11
ASSAM,2012,Car (Private),343,45,388
ASSAM,2012,Three Wheeler,71,4,75
ASSAM,2012,Two Wheeler,428,42,470
ASSAM,2012,Bicycle,51,4,55
ASSAM,2012,Pedestrian,92,4,96
ASSAM,2012,Others (Please Specify),315,15,330
ASSAM,2012,Total Deaths (Persons),2073,218,2291
ASSAM,2012,Total Truck/Lorry,427,28,455
ASSAM,2012,Total Bus,203,57,260
ASSAM,2012,Total Tempo/Vans,74,13,87
ASSAM,2012,Total Jeep,58,6,64
ASSAM,2012,Total Car,354,45,399
BIHAR,2001,Truck/Lorry (Government),15,10,25
BIHAR,2001,Truck/Lorry (Private),633,119,752
BIHAR,2001,Bus (Government),6,0,6
BIHAR,2001,Bus (Private),370,94,464
BIHAR,2001,Tempo/Vans (Government),0,0,0
BIHAR,2001,Tempo/Vans (Private),86,28,114
BIHAR,2001,Jeep (Government),6,0,6
BIHAR,2001,Jeep (Private),227,38,265
BIHAR,2001,Car (Government),0,0,0
BIHAR,2001,Car (Private),79,20,99
BIHAR,2001,Three Wheeler,23,7,30
BIHAR,2001,Two Wheeler,120,10,130
BIHAR,2001,Bicycle,18,1,19
BIHAR,2001,Pedestrian,13,4,17
BIHAR,2001,Others (Please Specify),298,45,343
BIHAR,2001,Total Deaths (Persons),1894,376,2270
BIHAR,2001,Total Truck/Lorry,648,129,777
BIHAR,2001,Total Bus,376,94,470
BIHAR,2001,Total Tempo/Vans,86,28,114
BIHAR,2001,Total Jeep,233,38,271
BIHAR,2001,Total Car,79,20,99
BIHAR,2002,Truck/Lorry (Government),2,0,2
BIHAR,2002,Truck/Lorry (Private),485,78,563
BIHAR,2002,Bus (Government),46,6,52
BIHAR,2002,Bus (Private),314,66,380
BIHAR,2002,Tempo/Vans (Government),2,0,2
BIHAR,2002,Tempo/Vans (Private),119,35,154
BIHAR,2002,Jeep (Government),5,3,8
BIHAR,2002,Jeep (Private),256,60,316
BIHAR,2002,Car (Government),1,0,1
BIHAR,2002,Car (Private),82,15,97
BIHAR,2002,Three Wheeler,47,9,56
BIHAR,2002,Two Wheeler,96,8,104
BIHAR,2002,Bicycle,17,3,20
BIHAR,2002,Pedestrian,40,2,42
BIHAR,2002,Others (Please Specify),289,58,347
BIHAR,2002,Total Deaths (Persons),1801,343,2144
BIHAR,2002,Total Truck/Lorry,487,78,565
BIHAR,2002,Total Bus,360,72,432
BIHAR,2002,Total Tempo/Vans,121,35,156
BIHAR,2002,Total Jeep,261,63,324
BIHAR,2002,Total Car,83,15,98
BIHAR,2003,Truck/Lorry (Government),72,5,77
BIHAR,2003,Truck/Lorry (Private),562,84,646
BIHAR,2003,Bus (Government),10,0,10
BIHAR,2003,Bus (Private),215,45,260
BIHAR,2003,Tempo/Vans (Government),10,0,10
BIHAR,2003,Tempo/Vans (Private),171,39,210
BIHAR,2003,Jeep (Government),17,0,17
BIHAR,2003,Jeep (Private),249,70,319
BIHAR,2003,Car (Government),2,0,2
BIHAR,2003,Car (Private),87,25,112
BIHAR,2003,Three Wheeler,41,8,49
BIHAR,2003,Two Wheeler,131,18,149
BIHAR,2003,Bicycle,31,3,34
BIHAR,2003,Pedestrian,70,14,84
BIHAR,2003,Others (Please Specify),191,23,214
BIHAR,2003,Total Deaths (Persons),1859,334,2193
BIHAR,2003,Total Truck/Lorry,634,89,723
BIHAR,2003,Total Bus,225,45,270
BIHAR,2003,Total Tempo/Vans,181,39,220
BIHAR,2003,Total Jeep,266,70,336
BIHAR,2003,Total Car,89,25,114
BIHAR,2004,Truck/Lorry (Government),11,9,20
BIHAR,2004,Truck/Lorry (Private),456,101,557
BIHAR,2004,Bus (Government),9,1,10
BIHAR,2004,Bus (Private),242,66,308
BIHAR,2004,Tempo/Vans (Government),1,0,1
BIHAR,2004,Tempo/Vans (Private),147,39,186
BIHAR,2004,Jeep (Government),5,2,7
BIHAR,2004,Jeep (Private),250,69,319
BIHAR,2004,Car (Government),3,0,3
BIHAR,2004,Car (Private),78,27,105
BIHAR,2004,Three Wheeler,22,2,24
BIHAR,2004,Two Wheeler,89,18,107
BIHAR,2004,Bicycle,27,0,27
BIHAR,2004,Pedestrian,79,29,108
BIHAR,2004,Others (Please Specify),241,76,317
BIHAR,2004,Total Deaths (Persons),1660,439,2099
BIHAR,2004,Total Truck/Lorry,467,110,577
BIHAR,2004,Total Bus,251,67,318
BIHAR,2004,Total Tempo/Vans,148,39,187
BIHAR,2004,Total Jeep,255,71,326
BIHAR,2004,Total Car,81,27,108
BIHAR,2005,Truck/Lorry (Government),28,9,37
BIHAR,2005,Truck/Lorry (Private),437,67,504
BIHAR,2005,Bus (Government),40,6,46
BIHAR,2005,Bus (Private),260,61,321
BIHAR,2005,Tempo/Vans (Government),17,1,18
BIHAR,2005,Tempo/Vans (Private),71,26,97
BIHAR,2005,Jeep (Government),8,2,10
BIHAR,2005,Jeep (Private),230,77,307
BIHAR,2005,Car (Government),18,0,18
BIHAR,2005,Car (Private),100,24,124
BIHAR,2005,Three Wheeler,52,10,62
BIHAR,2005,Two Wheeler,87,14,101
BIHAR,2005,Bicycle,36,1,37
BIHAR,2005,Pedestrian,35,9,44
BIHAR,2005,Others (Please Specify),365,57,422
BIHAR,2005,Total Deaths (Persons),1784,364,2148
BIHAR,2005,Total Truck/Lorry,465,76,541
BIHAR,2005,Total Bus,300,67,367
BIHAR,2005,Total Tempo/Vans,88,27,115
BIHAR,2005,Total Jeep,238,79,317
BIHAR,2005,Total Car,118,24,142
BIHAR,2006,Truck/Lorry (Government),17,7,24
BIHAR,2006,Truck/Lorry (Private),460,73,533
BIHAR,2006,Bus (Government),28,2,30
BIHAR,2006,Bus (Private),270,67,337
BIHAR,2006,Tempo/Vans (Government),9,2,11
BIHAR,2006,Tempo/Vans (Private),231,40,271
BIHAR,2006,Jeep (Government),18,10,28
BIHAR,2006,Jeep (Private),197,37,234
BIHAR,2006,Car (Government),29,2,31
BIHAR,2006,Car (Private),77,28,105
BIHAR,2006,Three Wheeler,32,8,40
BIHAR,2006,Two Wheeler,131,23,154
BIHAR,2006,Bicycle,60,4,64
BIHAR,2006,Pedestrian,45,11,56
BIHAR,2006,Others (Please Specify),248,65,313
BIHAR,2006,Total Deaths (Persons),1852,379,2231
BIHAR,2006,Total Truck/Lorry,477,80,557
BIHAR,2006,Total Bus,298,69,367
BIHAR,2006,Total Tempo/Vans,240,42,282
BIHAR,2006,Total Jeep,215,47,262
BIHAR,2006,Total Car,106,30,136
BIHAR,2007,Truck/Lorry (Government),2,3,5
BIHAR,2007,Truck/Lorry (Private),571,88,659
BIHAR,2007,Bus (Government),12,13,25
BIHAR,2007,Bus (Private),323,92,415
BIHAR,2007,Tempo/Vans (Government),2,0,2
BIHAR,2007,Tempo/Vans (Private),160,57,217
BIHAR,2007,Jeep (Government),13,10,23
BIHAR,2007,Jeep (Private),316,82,398
BIHAR,2007,Car (Government),10,6,16
BIHAR,2007,Car (Private),100,42,142
BIHAR,2007,Three Wheeler,122,33,155
BIHAR,2007,Two Wheeler,202,47,249
BIHAR,2007,Bicycle,61,4,65
BIHAR,2007,Pedestrian,66,35,101
BIHAR,2007,Others (Please Specify),243,89,332
BIHAR,2007,Total Deaths (Persons),2203,601,2804
BIHAR,2007,Total Truck/Lorry,573,91,664
BIHAR,2007,Total Bus,335,105,440
BIHAR,2007,Total Tempo/Vans,162,57,219
BIHAR,2007,Total Jeep,329,92,421
BIHAR,2007,Total Car,110,48,158
BIHAR,2008,Truck/Lorry (Government),6,4,10
BIHAR,2008,Truck/Lorry (Private),701,153,854
BIHAR,2008,Bus (Government),12,1,13
BIHAR,2008,Bus (Private),301,51,352
BIHAR,2008,Tempo/Vans (Government),8,2,10
BIHAR,2008,Tempo/Vans (Private),185,40,225
BIHAR,2008,Jeep (Government),30,8,38
BIHAR,2008,Jeep (Private),388,87,475
BIHAR,2008,Car (Government),1,1,2
BIHAR,2008,Car (Private),103,21,124
BIHAR,2008,Three Wheeler,82,18,100
BIHAR,2008,Two Wheeler,363,36,399
BIHAR,2008,Bicycle,52,5,57
BIHAR,2008,Pedestrian,92,23,115
BIHAR,2008,Others (Please Specify),630,67,697
BIHAR,2008,Total Deaths (Persons),2954,517,3471
BIHAR,2008,Total Truck/Lorry,707,157,864
BIHAR,2008,Total Bus,313,52,365
BIHAR,2008,Total Tempo/Vans,193,42,235
BIHAR,2008,Total Jeep,418,95,513
BIHAR,2008,Total Car,104,22,126
BIHAR,2009,Truck/Lorry (Government),53,17,70
BIHAR,2009,Truck/Lorry (Private),852,140,992
BIHAR,2009,Bus (Government),49,10,59
BIHAR,2009,Bus (Private),329,86,415
BIHAR,2009,Tempo/Vans (Government),36,0,36
BIHAR,2009,Tempo/Vans (Private),341,77,418
BIHAR,2009,Jeep (Government),3,1,4
BIHAR,2009,Jeep (Private),435,111,546
BIHAR,2009,Car (Government),6,0,6
BIHAR,2009,Car (Private),158,30,188
BIHAR,2009,Three Wheeler,95,53,148
BIHAR,2009,Two Wheeler,355,48,403
BIHAR,2009,Bicycle,67,12,79
BIHAR,2009,Pedestrian,220,58,278
BIHAR,2009,Others (Please Specify),600,163,763
BIHAR,2009,Total Deaths (Persons),3599,806,4405
BIHAR,2009,Total Truck/Lorry,905,157,1062
BIHAR,2009,Total Bus,378,96,474
BIHAR,2009,Total Tempo/Vans,377,77,454
BIHAR,2009,Total Jeep,438,112,550
BIHAR,2009,Total Car,164,30,194
BIHAR,2010,Truck/Lorry (Government),43,5,48
BIHAR,2010,Truck/Lorry (Private),1040,132,1172
BIHAR,2010,Bus (Government),12,7,19
BIHAR,2010,Bus (Private),403,122,525
BIHAR,2010,Tempo/Vans (Government),3,0,3
BIHAR,2010,Tempo/Vans (Private),248,81,329
BIHAR,2010,Jeep (Government),10,3,13
BIHAR,2010,Jeep (Private),399,123,522
BIHAR,2010,Car (Government),15,1,16
BIHAR,2010,Car (Private),224,51,275
BIHAR,2010,Three Wheeler,223,64,287
BIHAR,2010,Two Wheeler,335,58,393
BIHAR,2010,Bicycle,86,19,105
BIHAR,2010,Pedestrian,235,31,266
BIHAR,2010,Others (Please Specify),624,96,720
BIHAR,2010,Total Deaths (Persons),3900,793,4693
BIHAR,2010,Total Truck/Lorry,1083,137,1220
BIHAR,2010,Total Bus,415,129,544
BIHAR,2010,Total Tempo/Vans,251,81,332
BIHAR,2010,Total Jeep,409,126,535
BIHAR,2010,Total Car,239,52,291
BIHAR,2011,Truck/Lorry (Government),35,13,48
BIHAR,2011,Truck/Lorry (Private),949,149,1098
BIHAR,2011,Bus (Government),31,10,41
BIHAR,2011,Bus (Private),592,122,714
BIHAR,2011,Tempo/Vans (Government),4,0,4
BIHAR,2011,Tempo/Vans (Private),306,71,377
BIHAR,2011,Jeep (Government),12,2,14
BIHAR,2011,Jeep (Private),370,71,441
BIHAR,2011,Car (Government),1,0,1
BIHAR,2011,Car (Private),301,48,349
BIHAR,2011,Three Wheeler,187,25,212
BIHAR,2011,Two Wheeler,535,88,623
BIHAR,2011,Bicycle,108,28,136
BIHAR,2011,Pedestrian,118,34,152
BIHAR,2011,Others (Please Specify),726,136,862
BIHAR,2011,Total Deaths (Persons),4275,797,5072
BIHAR,2011,Total Truck/Lorry,984,162,1146
BIHAR,2011,Total Bus,623,132,755
BIHAR,2011,Total Tempo/Vans,310,71,381
BIHAR,2011,Total Jeep,382,73,455
BIHAR,2011,Total Car,302,48,350
BIHAR,2012,Truck/Lorry (Government),16,0,16
BIHAR,2012,Truck/Lorry (Private),823,133,956
BIHAR,2012,Bus (Government),23,2,25
BIHAR,2012,Bus (Private),738,126,864
BIHAR,2012,Tempo/Vans (Government),1,0,1
BIHAR,2012,Tempo/Vans (Private),361,81,442
BIHAR,2012,Jeep (Government),7,1,8
BIHAR,2012,Jeep (Private),393,79,472
BIHAR,2012,Car (Government),13,0,13
BIHAR,2012,Car (Private),223,62,285
BIHAR,2012,Three Wheeler,179,31,210
BIHAR,2012,Two Wheeler,549,89,638
BIHAR,2012,Bicycle,88,7,95
BIHAR,2012,Pedestrian,145,49,194
BIHAR,2012,Others (Please Specify),693,144,837
BIHAR,2012,Total Deaths (Persons),4252,804,5056
BIHAR,2012,Total Truck/Lorry,839,133,972
BIHAR,2012,Total Bus,761,128,889
BIHAR,2012,Total Tempo/Vans,362,81,443
BIHAR,2012,Total Jeep,400,80,480
BIHAR,2012,Total Car,236,62,298
CHHATTISGARH,2001,Truck/Lorry (Government),38,17,55
CHHATTISGARH,2001,Truck/Lorry (Private),372,64,436
CHHATTISGARH,2001,Bus (Government),53,10,63
CHHATTISGARH,2001,Bus (Private),16,4,20
CHHATTISGARH,2001,Tempo/Vans (Government),14,4,18
CHHATTISGARH,2001,Tempo/Vans (Private),52,13,65
CHHATTISGARH,2001,Jeep (Government),9,3,12
CHHATTISGARH,2001,Jeep (Private),133,22,155
CHHATTISGARH,2001,Car (Government),1,0,1
CHHATTISGARH,2001,Car (Private),30,5,35
CHHATTISGARH,2001,Three Wheeler,10,1,11
CHHATTISGARH,2001,Two Wheeler,202,21,223
CHHATTISGARH,2001,Bicycle,36,5,41
CHHATTISGARH,2001,Pedestrian,48,17,65
CHHATTISGARH,2001,Others (Please Specify),129,11,140
CHHATTISGARH,2001,Total Deaths (Persons),1143,197,1340
CHHATTISGARH,2001,Total Truck/Lorry,410,81,491
CHHATTISGARH,2001,Total Bus,69,14,83
CHHATTISGARH,2001,Total Tempo/Vans,66,17,83
CHHATTISGARH,2001,Total Jeep,142,25,167
CHHATTISGARH,2001,Total Car,31,5,36
CHHATTISGARH,2002,Truck/Lorry (Government),5,0,5
CHHATTISGARH,2002,Truck/Lorry (Private),356,63,419
CHHATTISGARH,2002,Bus (Government),5,0,5
CHHATTISGARH,2002,Bus (Private),86,23,109
CHHATTISGARH,2002,Tempo/Vans (Government),0,0,0
CHHATTISGARH,2002,Tempo/Vans (Private),50,17,67
CHHATTISGARH,2002,Jeep (Government),2,0,2
CHHATTISGARH,2002,Jeep (Private),164,33,197
CHHATTISGARH,2002,Car (Government),0,0,0
CHHATTISGARH,2002,Car (Private),37,4,41
CHHATTISGARH,2002,Three Wheeler,14,1,15
CHHATTISGARH,2002,Two Wheeler,316,28,344
CHHATTISGARH,2002,Bicycle,123,15,138
CHHATTISGARH,2002,Pedestrian,115,40,155
CHHATTISGARH,2002,Others (Please Specify),283,44,327
CHHATTISGARH,2002,Total Deaths (Persons),1556,268,1824
CHHATTISGARH,2002,Total Truck/Lorry,361,63,424
CHHATTISGARH,2002,Total Bus,91,23,114
CHHATTISGARH,2002,Total Tempo/Vans,50,17,67
CHHATTISGARH,2002,Total Jeep,166,33,199
CHHATTISGARH,2002,Total Car,37,4,41
CHHATTISGARH,2003,Truck/Lorry (Government),22,3,25
CHHATTISGARH,2003,Truck/Lorry (Private),503,89,592
CHHATTISGARH,2003,Bus (Government),0,0,0
CHHATTISGARH,2003,Bus (Private),132,22,154
CHHATTISGARH,2003,Tempo/Vans (Government),0,0,0
CHHATTISGARH,2003,Tempo/Vans (Private),59,11,70
CHHATTISGARH,2003,Jeep (Government),6,3,9
CHHATTISGARH,2003,Jeep (Private),192,30,222
CHHATTISGARH,2003,Car (Government),1,0,1
CHHATTISGARH,2003,Car (Private),57,3,60
CHHATTISGARH,2003,Three Wheeler,13,0,13
CHHATTISGARH,2003,Two Wheeler,296,37,333
CHHATTISGARH,2003,Bicycle,69,4,73
CHHATTISGARH,2003,Pedestrian,125,17,142
CHHATTISGARH,2003,Others (Please Specify),279,62,341
CHHATTISGARH,2003,Total Deaths (Persons),1754,281,2035
CHHATTISGARH,2003,Total Truck/Lorry,525,92,617
CHHATTISGARH,2003,Total Bus,132,22,154
CHHATTISGARH,2003,Total Tempo/Vans,59,11,70
CHHATTISGARH,2003,Total Jeep,198,33,231
CHHATTISGARH,2003,Total Car,58,3,61
CHHATTISGARH,2004,Truck/Lorry (Government),15,3,18
CHHATTISGARH,2004,Truck/Lorry (Private),459,69,528
CHHATTISGARH,2004,Bus (Government),29,6,35
CHHATTISGARH,2004,Bus (Private),58,16,74
CHHATTISGARH,2004,Tempo/Vans (Government),1,0,1
CHHATTISGARH,2004,Tempo/Vans (Private),58,20,78
CHHATTISGARH,2004,Jeep (Government),9,2,11
CHHATTISGARH,2004,Jeep (Private),180,31,211
CHHATTISGARH,2004,Car (Government),0,0,0
CHHATTISGARH,2004,Car (Private),41,6,47
CHHATTISGARH,2004,Three Wheeler,27,2,29
CHHATTISGARH,2004,Two Wheeler,405,40,445
CHHATTISGARH,2004,Bicycle,68,10,78
CHHATTISGARH,2004,Pedestrian,153,48,201
CHHATTISGARH,2004,Others (Please Specify),417,77,494
CHHATTISGARH,2004,Total Deaths (Persons),1920,330,2250
CHHATTISGARH,2004,Total Truck/Lorry,474,72,546
CHHATTISGARH,2004,Total Bus,87,22,109
CHHATTISGARH,2004,Total Tempo/Vans,59,20,79
CHHATTISGARH,2004,Total Jeep,189,33,222
CHHATTISGARH,2004,Total Car,41,6,47
CHHATTISGARH,2005,Truck/Lorry (Government),0,0,0
CHHATTISGARH,2005,Truck/Lorry (Private),454,80,534
CHHATTISGARH,2005,Bus (Government),0,0,0
CHHATTISGARH,2005,Bus (Private),167,37,204
CHHATTISGARH,2005,Tempo/Vans (Government),1,0,1
CHHATTISGARH,2005,Tempo/Vans (Private),82,13,95
CHHATTISGARH,2005,Jeep (Government),1,0,1
CHHATTISGARH,2005,Jeep (Private),204,35,239
CHHATTISGARH,2005,Car (Government),3,0,3
CHHATTISGARH,2005,Car (Private),75,7,82
CHHATTISGARH,2005,Three Wheeler,12,3,15
CHHATTISGARH,2005,Two Wheeler,397,60,457
CHHATTISGARH,2005,Bicycle,152,4,156
CHHATTISGARH,2005,Pedestrian,179,27,206
CHHATTISGARH,2005,Others (Please Specify),302,30,332
CHHATTISGARH,2005,Total Deaths (Persons),2029,296,2325
CHHATTISGARH,2005,Total Truck/Lorry,454,80,534
CHHATTISGARH,2005,Total Bus,167,37,204
CHHATTISGARH,2005,Total Tempo/Vans,83,13,96
CHHATTISGARH,2005,Total Jeep,205,35,240
CHHATTISGARH,2005,Total Car,78,7,85
CHHATTISGARH,2006,Truck/Lorry (Government),2,0,2
CHHATTISGARH,2006,Truck/Lorry (Private),652,112,764
CHHATTISGARH,2006,Bus (Government),0,0,0
CHHATTISGARH,2006,Bus (Private),140,30,170
CHHATTISGARH,2006,Tempo/Vans (Government),3,0,3
CHHATTISGARH,2006,Tempo/Vans (Private),71,6,77
CHHATTISGARH,2006,Jeep (Government),0,1,1
CHHATTISGARH,2006,Jeep (Private),164,32,196
CHHATTISGARH,2006,Car (Government),2,0,2
CHHATTISGARH,2006,Car (Private),82,27,109
CHHATTISGARH,2006,Three Wheeler,29,2,31
CHHATTISGARH,2006,Two Wheeler,377,64,441
CHHATTISGARH,2006,Bicycle,148,11,159
CHHATTISGARH,2006,Pedestrian,114,22,136
CHHATTISGARH,2006,Others (Please Specify),424,59,483
CHHATTISGARH,2006,Total Deaths (Persons),2208,366,2574
CHHATTISGARH,2006,Total Truck/Lorry,654,112,766
CHHATTISGARH,2006,Total Bus,140,30,170
CHHATTISGARH,2006,Total Tempo/Vans,74,6,80
CHHATTISGARH,2006,Total Jeep,164,33,197
CHHATTISGARH,2006,Total Car,84,27,111
CHHATTISGARH,2007,Truck/Lorry (Government),0,0,0
CHHATTISGARH,2007,Truck/Lorry (Private),649,70,719
CHHATTISGARH,2007,Bus (Government),0,0,0
CHHATTISGARH,2007,Bus (Private),161,27,188
CHHATTISGARH,2007,Tempo/Vans (Government),0,0,0
CHHATTISGARH,2007,Tempo/Vans (Private),81,9,90
CHHATTISGARH,2007,Jeep (Government),4,1,5
CHHATTISGARH,2007,Jeep (Private),151,44,195
CHHATTISGARH,2007,Car (Government),9,0,9
CHHATTISGARH,2007,Car (Private),110,17,127
CHHATTISGARH,2007,Three Wheeler,27,1,28
CHHATTISGARH,2007,Two Wheeler,494,66,560
CHHATTISGARH,2007,Bicycle,70,9,79
CHHATTISGARH,2007,Pedestrian,137,29,166
CHHATTISGARH,2007,Others (Please Specify),636,130,766
CHHATTISGARH,2007,Total Deaths (Persons),2529,403,2932
CHHATTISGARH,2007,Total Truck/Lorry,649,70,719
CHHATTISGARH,2007,Total Bus,161,27,188
CHHATTISGARH,2007,Total Tempo/Vans,81,9,90
CHHATTISGARH,2007,Total Jeep,155,45,200
CHHATTISGARH,2007,Total Car,119,17,136
CHHATTISGARH,2008,Truck/Lorry (Government),0,0,0
CHHATTISGARH,2008,Truck/Lorry (Private),698,92,790
CHHATTISGARH,2008,Bus (Government),92,14,106
CHHATTISGARH,2008,Bus (Private),49,14,63
CHHATTISGARH,2008,Tempo/Vans (Government),0,0,0
CHHATTISGARH,2008,Tempo/Vans (Private),83,20,103
CHHATTISGARH,2008,Jeep (Government),0,1,1
CHHATTISGARH,2008,Jeep (Private),176,31,207
CHHATTISGARH,2008,Car (Government),1,0,1
CHHATTISGARH,2008,Car (Private),105,13,118
CHHATTISGARH,2008,Three Wheeler,27,2,29
CHHATTISGARH,2008,Two Wheeler,757,70,827
CHHATTISGARH,2008,Bicycle,77,7,84
CHHATTISGARH,2008,Pedestrian,165,48,213
CHHATTISGARH,2008,Others (Please Specify),615,86,701
CHHATTISGARH,2008,Total Deaths (Persons),2845,398,3243
CHHATTISGARH,2008,Total Truck/Lorry,698,92,790
CHHATTISGARH,2008,Total Bus,141,28,169
CHHATTISGARH,2008,Total Tempo/Vans,83,20,103
CHHATTISGARH,2008,Total Jeep,176,32,208
CHHATTISGARH,2008,Total Car,106,13,119
CHHATTISGARH,2009,Truck/Lorry (Government),46,0,46
CHHATTISGARH,2009,Truck/Lorry (Private),522,69,591
CHHATTISGARH,2009,Bus (Government),10,1,11
CHHATTISGARH,2009,Bus (Private),132,36,168
CHHATTISGARH,2009,Tempo/Vans (Government),0,0,0
CHHATTISGARH,2009,Tempo/Vans (Private),113,19,132
CHHATTISGARH,2009,Jeep (Government),3,0,3
CHHATTISGARH,2009,Jeep (Private),228,42,270
CHHATTISGARH,2009,Car (Government),0,0,0
CHHATTISGARH,2009,Car (Private),140,17,157
CHHATTISGARH,2009,Three Wheeler,45,5,50
CHHATTISGARH,2009,Two Wheeler,636,78,714
CHHATTISGARH,2009,Bicycle,120,13,133
CHHATTISGARH,2009,Pedestrian,152,47,199
CHHATTISGARH,2009,Others (Please Specify),596,88,684
CHHATTISGARH,2009,Total Deaths (Persons),2743,415,3158
CHHATTISGARH,2009,Total Truck/Lorry,568,69,637
CHHATTISGARH,2009,Total Bus,142,37,179
CHHATTISGARH,2009,Total Tempo/Vans,113,19,132
CHHATTISGARH,2009,Total Jeep,231,42,273
CHHATTISGARH,2009,Total Car,140,17,157
CHHATTISGARH,2010,Truck/Lorry (Government),154,20,174
CHHATTISGARH,2010,Truck/Lorry (Private),452,72,524
CHHATTISGARH,2010,Bus (Government),85,8,93
CHHATTISGARH,2010,Bus (Private),137,21,158
CHHATTISGARH,2010,Tempo/Vans (Government),0,0,0
CHHATTISGARH,2010,Tempo/Vans (Private),128,16,144
CHHATTISGARH,2010,Jeep (Government),23,1,24
CHHATTISGARH,2010,Jeep (Private),209,38,247
CHHATTISGARH,2010,Car (Government),0,0,0
CHHATTISGARH,2010,Car (Private),149,16,165
CHHATTISGARH,2010,Three Wheeler,45,5,50
CHHATTISGARH,2010,Two Wheeler,344,51,395
CHHATTISGARH,2010,Bicycle,148,12,160
CHHATTISGARH,2010,Pedestrian,196,27,223
CHHATTISGARH,2010,Others (Please Specify),451,80,531
CHHATTISGARH,2010,Total Deaths (Persons),2521,367,2888
CHHATTISGARH,2010,Total Truck/Lorry,606,92,698
CHHATTISGARH,2010,Total Bus,222,29,251
CHHATTISGARH,2010,Total Tempo/Vans,128,16,144
CHHATTISGARH,2010,Total Jeep,232,39,271
CHHATTISGARH,2010,Total Car,149,16,165
CHHATTISGARH,2011,Truck/Lorry (Government),1,4,5
CHHATTISGARH,2011,Truck/Lorry (Private),724,87,811
CHHATTISGARH,2011,Bus (Government),18,6,24
CHHATTISGARH,2011,Bus (Private),135,20,155
CHHATTISGARH,2011,Tempo/Vans (Government),1,0,1
CHHATTISGARH,2011,Tempo/Vans (Private),162,27,189
CHHATTISGARH,2011,Jeep (Government),18,6,24
CHHATTISGARH,2011,Jeep (Private),249,29,278
CHHATTISGARH,2011,Car (Government),1,0,1
CHHATTISGARH,2011,Car (Private),144,21,165
CHHATTISGARH,2011,Three Wheeler,76,9,85
CHHATTISGARH,2011,Two Wheeler,820,101,921
CHHATTISGARH,2011,Bicycle,118,12,130
CHHATTISGARH,2011,Pedestrian,190,50,240
CHHATTISGARH,2011,Others (Please Specify),370,55,425
CHHATTISGARH,2011,Total Deaths (Persons),3027,427,3454
CHHATTISGARH,2011,Total Truck/Lorry,725,91,816
CHHATTISGARH,2011,Total Bus,153,26,179
CHHATTISGARH,2011,Total Tempo/Vans,163,27,190
CHHATTISGARH,2011,Total Jeep,267,35,302
CHHATTISGARH,2011,Total Car,145,21,166
CHHATTISGARH,2012,Truck/Lorry (Government),3,1,4
CHHATTISGARH,2012,Truck/Lorry (Private),709,87,796
CHHATTISGARH,2012,Bus (Government),22,5,27
CHHATTISGARH,2012,Bus (Private),102,18,120
CHHATTISGARH,2012,Tempo/Vans (Government),1,0,1
CHHATTISGARH,2012,Tempo/Vans (Private),74,16,90
CHHATTISGARH,2012,Jeep (Government),6,3,9
CHHATTISGARH,2012,Jeep (Private),183,28,211
CHHATTISGARH,2012,Car (Government),0,0,0
CHHATTISGARH,2012,Car (Private),119,20,139
CHHATTISGARH,2012,Three Wheeler,21,3,24
CHHATTISGARH,2012,Two Wheeler,655,80,735
CHHATTISGARH,2012,Bicycle,59,5,64
CHHATTISGARH,2012,Pedestrian,141,48,189
CHHATTISGARH,2012,Others (Please Specify),641,117,758
CHHATTISGARH,2012,Total Deaths (Persons),2736,431,3167
CHHATTISGARH,2012,Total Truck/Lorry,712,88,800
CHHATTISGARH,2012,Total Bus,124,23,147
CHHATTISGARH,2012,Total Tempo/Vans,75,16,91
CHHATTISGARH,2012,Total Jeep,189,31,220
CHHATTISGARH,2012,Total Car,119,20,139
GOA,2001,Truck/Lorry (Government),0,0,0
GOA,2001,Truck/Lorry (Private),21,6,27
GOA,2001,Bus (Government),1,0,1
GOA,2001,Bus (Private),10,5,15
GOA,2001,Tempo/Vans (Government),2,0,2
GOA,2001,Tempo/Vans (Private),6,1,7
GOA,2001,Jeep (Government),0,0,0
GOA,2001,Jeep (Private),4,1,5
GOA,2001,Car (Government),0,0,0
GOA,2001,Car (Private),10,0,10
GOA,2001,Three Wheeler,7,0,7
GOA,2001,Two Wheeler,84,9,93
GOA,2001,Bicycle,7,1,8
GOA,2001,Pedestrian,27,15,42
GOA,2001,Others (Please Specify),9,1,10
GOA,2001,Total Deaths (Persons),188,39,227
GOA,2001,Total Truck/Lorry,21,6,27
GOA,2001,Total Bus,11,5,16
GOA,2001,Total Tempo/Vans,8,1,9
GOA,2001,Total Jeep,4,1,5
GOA,2001,Total Car,10,0,10
GOA,2002,Truck/Lorry (Government),0,0,0
GOA,2002,Truck/Lorry (Private),1,1,2
GOA,2002,Bus (Government),1,0,1
GOA,2002,Bus (Private),5,0,5
GOA,2002,Tempo/Vans (Government),0,0,0
GOA,2002,Tempo/Vans (Private),2,0,2
GOA,2002,Jeep (Government),0,0,0
GOA,2002,Jeep (Private),1,0,1
GOA,2002,Car (Government),0,0,0
GOA,2002,Car (Private),3,1,4
GOA,2002,Three Wheeler,13,6,19
GOA,2002,Two Wheeler,38,1,39
GOA,2002,Bicycle,3,0,3
GOA,2002,Pedestrian,18,4,22
GOA,2002,Others (Please Specify),125,18,143
GOA,2002,Total Deaths (Persons),210,31,241
GOA,2002,Total Truck/Lorry,1,1,2
GOA,2002,Total Bus,6,0,6
GOA,2002,Total Tempo/Vans,2,0,2
GOA,2002,Total Jeep,1,0,1
GOA,2002,Total Car,3,1,4
GOA,2003,Truck/Lorry (Government),0,0,0
GOA,2003,Truck/Lorry (Private),19,0,19
GOA,2003,Bus (Government),4,2,6
GOA,2003,Bus (Private),7,2,9
GOA,2003,Tempo/Vans (Government),0,0,0
GOA,2003,Tempo/Vans (Private),11,1,12
GOA,2003,Jeep (Government),0,0,0
GOA,2003,Jeep (Private),3,0,3
GOA,2003,Car (Government),0,0,0
GOA,2003,Car (Private),7,0,7
GOA,2003,Three Wheeler,14,1,15
GOA,2003,Two Wheeler,91,10,101
GOA,2003,Bicycle,8,0,8
GOA,2003,Pedestrian,28,14,42
GOA,2003,Others (Please Specify),9,0,9
GOA,2003,Total Deaths (Persons),201,30,231
GOA,2003,Total Truck/Lorry,19,0,19
GOA,2003,Total Bus,11,4,15
GOA,2003,Total Tempo/Vans,11,1,12
GOA,2003,Total Jeep,3,0,3
GOA,2003,Total Car,7,0,7
GOA,2004,Truck/Lorry (Government),0,0,0
GOA,2004,Truck/Lorry (Private),18,3,21
GOA,2004,Bus (Government),0,0,0
GOA,2004,Bus (Private),10,1,11
GOA,2004,Tempo/Vans (Government),1,0,1
GOA,2004,Tempo/Vans (Private),6,1,7
GOA,2004,Jeep (Government),0,0,0
GOA,2004,Jeep (Private),6,0,6
GOA,2004,Car (Government),0,0,0
GOA,2004,Car (Private),17,4,21
GOA,2004,Three Wheeler,10,1,11
GOA,2004,Two Wheeler,139,14,153
GOA,2004,Bicycle,11,0,11
GOA,2004,Pedestrian,47,22,69
GOA,2004,Others (Please Specify),7,1,8
GOA,2004,Total Deaths (Persons),272,47,319
GOA,2004,Total Truck/Lorry,18,3,21
GOA,2004,Total Bus,10,1,11
GOA,2004,Total Tempo/Vans,7,1,8
GOA,2004,Total Jeep,6,0,6
GOA,2004,Total Car,17,4,21
GOA,2005,Truck/Lorry (Government),0,0,0
GOA,2005,Truck/Lorry (Private),16,2,18
GOA,2005,Bus (Government),0,0,0
GOA,2005,Bus (Private),3,0,3
GOA,2005,Tempo/Vans (Government),0,0,0
GOA,2005,Tempo/Vans (Private),6,0,6
GOA,2005,Jeep (Government),0,0,0
GOA,2005,Jeep (Private),5,0,5
GOA,2005,Car (Government),0,0,0
GOA,2005,Car (Private),14,3,17
GOA,2005,Three Wheeler,6,1,7
GOA,2005,Two Wheeler,129,8,137
GOA,2005,Bicycle,8,0,8
GOA,2005,Pedestrian,39,17,56
GOA,2005,Others (Please Specify),1,0,1
GOA,2005,Total Deaths (Persons),227,31,258
GOA,2005,Total Truck/Lorry,16,2,18
GOA,2005,Total Bus,3,0,3
GOA,2005,Total Tempo/Vans,6,0,6
GOA,2005,Total Jeep,5,0,5
GOA,2005,Total Car,14,3,17
GOA,2006,Truck/Lorry (Government),0,0,0
GOA,2006,Truck/Lorry (Private),17,1,18
GOA,2006,Bus (Government),0,0,0
GOA,2006,Bus (Private),10,0,10
GOA,2006,Tempo/Vans (Government),1,0,1
GOA,2006,Tempo/Vans (Private),7,1,8
GOA,2006,Jeep (Government),0,0,0
GOA,2006,Jeep (Private),3,1,4
GOA,2006,Car (Government),0,0,0
GOA,2006,Car (Private),13,4,17
GOA,2006,Three Wheeler,26,5,31
GOA,2006,Two Wheeler,112,15,127
GOA,2006,Bicycle,13,1,14
GOA,2006,Pedestrian,56,18,74
GOA,2006,Others (Please Specify),5,1,6
GOA,2006,Total Deaths (Persons),263,47,310
GOA,2006,Total Truck/Lorry,17,1,18
GOA,2006,Total Bus,10,0,10
GOA,2006,Total Tempo/Vans,8,1,9
GOA,2006,Total Jeep,3,1,4
GOA,2006,Total Car,13,4,17
GOA,2007,Truck/Lorry (Government),0,0,0
GOA,2007,Truck/Lorry (Private),19,3,22
GOA,2007,Bus (Government),1,0,1
GOA,2007,Bus (Private),5,1,6
GOA,2007,Tempo/Vans (Government),0,0,0
GOA,2007,Tempo/Vans (Private),11,0,11
GOA,2007,Jeep (Government),0,0,0
GOA,2007,Jeep (Private),5,1,6
GOA,2007,Car (Government),0,0,0
GOA,2007,Car (Private),10,2,12
GOA,2007,Three Wheeler,1,1,2
GOA,2007,Two Wheeler,174,19,193
GOA,2007,Bicycle,12,0,12
GOA,2007,Pedestrian,54,14,68
GOA,2007,Others (Please Specify),7,0,7
GOA,2007,Total Deaths (Persons),299,41,340
GOA,2007,Total Truck/Lorry,19,3,22
GOA,2007,Total Bus,6,1,7
GOA,2007,Total Tempo/Vans,11,0,11
GOA,2007,Total Jeep,5,1,6
GOA,2007,Total Car,10,2,12
GOA,2008,Truck/Lorry (Government),0,0,0
GOA,2008,Truck/Lorry (Private),23,0,23
GOA,2008,Bus (Government),2,0,2
GOA,2008,Bus (Private),13,8,21
GOA,2008,Tempo/Vans (Government),0,0,0
GOA,2008,Tempo/Vans (Private),10,1,11
GOA,2008,Jeep (Government),1,0,1
GOA,2008,Jeep (Private),17,1,18
GOA,2008,Car (Government),0,0,0
GOA,2008,Car (Private),12,2,14
GOA,2008,Three Wheeler,14,1,15
GOA,2008,Two Wheeler,138,11,149
GOA,2008,Bicycle,10,2,12
GOA,2008,Pedestrian,41,16,57
GOA,2008,Others (Please Specify),9,1,10
GOA,2008,Total Deaths (Persons),290,43,333
GOA,2008,Total Truck/Lorry,23,0,23
GOA,2008,Total Bus,15,8,23
GOA,2008,Total Tempo/Vans,10,1,11
GOA,2008,Total Jeep,18,1,19
GOA,2008,Total Car,12,2,14
GOA,2009,Truck/Lorry (Government),0,0,0
GOA,2009,Truck/Lorry (Private),26,0,26
GOA,2009,Bus (Government),0,0,0
GOA,2009,Bus (Private),1,0,1
GOA,2009,Tempo/Vans (Government),0,0,0
GOA,2009,Tempo/Vans (Private),7,0,7
GOA,2009,Jeep (Government),0,0,0
GOA,2009,Jeep (Private),4,1,5
GOA,2009,Car (Government),0,0,0
GOA,2009,Car (Private),16,3,19
GOA,2009,Three Wheeler,4,0,4
GOA,2009,Two Wheeler,168,12,180
GOA,2009,Bicycle,7,0,7
GOA,2009,Pedestrian,50,15,65
GOA,2009,Others (Please Specify),6,4,10
GOA,2009,Total Deaths (Persons),289,35,324
GOA,2009,Total Truck/Lorry,26,0,26
GOA,2009,Total Bus,1,0,1
GOA,2009,Total Tempo/Vans,7,0,7
GOA,2009,Total Jeep,4,1,5
GOA,2009,Total Car,16,3,19
GOA,2010,Truck/Lorry (Government),1,0,1
GOA,2010,Truck/Lorry (Private),10,1,11
GOA,2010,Bus (Government),0,0,0
GOA,2010,Bus (Private),7,4,11
GOA,2010,Tempo/Vans (Government),0,0,0
GOA,2010,Tempo/Vans (Private),2,0,2
GOA,2010,Jeep (Government),1,0,1
GOA,2010,Jeep (Private),7,0,7
GOA,2010,Car (Government),0,0,0
GOA,2010,Car (Private),15,3,18
GOA,2010,Three Wheeler,2,0,2
GOA,2010,Two Wheeler,167,24,191
GOA,2010,Bicycle,5,0,5
GOA,2010,Pedestrian,73,15,88
GOA,2010,Others (Please Specify),5,0,5
GOA,2010,Total Deaths (Persons),295,47,342
GOA,2010,Total Truck/Lorry,11,1,12
GOA,2010,Total Bus,7,4,11
GOA,2010,Total Tempo/Vans,2,0,2
GOA,2010,Total Jeep,8,0,8
GOA,2010,Total Car,15,3,18
GOA,2011,Truck/Lorry (Government),0,0,0
GOA,2011,Truck/Lorry (Private),16,1,17
GOA,2011,Bus (Government),0,0,0
GOA,2011,Bus (Private),8,0,8
GOA,2011,Tempo/Vans (Government),0,0,0
GOA,2011,Tempo/Vans (Private),4,1,5
GOA,2011,Jeep (Government),1,0,1
GOA,2011,Jeep (Private),5,2,7
GOA,2011,Car (Government),0,0,0
GOA,2011,Car (Private),12,3,15
GOA,2011,Three Wheeler,3,0,3
GOA,2011,Two Wheeler,152,11,163
GOA,2011,Bicycle,15,0,15
GOA,2011,Pedestrian,84,13,97
GOA,2011,Others (Please Specify),5,2,7
GOA,2011,Total Deaths (Persons),305,33,338
GOA,2011,Total Truck/Lorry,16,1,17
GOA,2011,Total Bus,8,0,8
GOA,2011,Total Tempo/Vans,4,1,5
GOA,2011,Total Jeep,6,2,8
GOA,2011,Total Car,12,3,15
GOA,2012,Truck/Lorry (Government),0,0,0
GOA,2012,Truck/Lorry (Private),10,0,10
GOA,2012,Bus (Government),2,0,2
GOA,2012,Bus (Private),6,7,13
GOA,2012,Tempo/Vans (Government),0,0,0
GOA,2012,Tempo/Vans (Private),2,0,2
GOA,2012,Jeep (Government),0,0,0
GOA,2012,Jeep (Private),1,0,1
GOA,2012,Car (Government),0,0,0
GOA,2012,Car (Private),23,4,27
GOA,2012,Three Wheeler,11,2,13
GOA,2012,Two Wheeler,162,11,173
GOA,2012,Bicycle,2,0,2
GOA,2012,Pedestrian,37,13,50
GOA,2012,Others (Please Specify),9,0,9
GOA,2012,Total Deaths (Persons),265,37,302
GOA,2012,Total Truck/Lorry,10,0,10
GOA,2012,Total Bus,8,7,15
GOA,2012,Total Tempo/Vans,2,0,2
GOA,2012,Total Jeep,1,0,1
GOA,2012,Total Car,23,4,27
GUJARAT,2001,Truck/Lorry (Government),10,1,11
GUJARAT,2001,Truck/Lorry (Private),898,123,1021
GUJARAT,2001,Bus (Government),164,32,196
GUJARAT,2001,Bus (Private),149,40,189
GUJARAT,2001,Tempo/Vans (Government),1,0,1
GUJARAT,2001,Tempo/Vans (Private),241,59,300
GUJARAT,2001,Jeep (Government),8,0,8
GUJARAT,2001,Jeep (Private),411,91,502
GUJARAT,2001,Car (Government),2,1,3
GUJARAT,2001,Car (Private),205,53,258
GUJARAT,2001,Three Wheeler,224,51,275
GUJARAT,2001,Two Wheeler,521,94,615
GUJARAT,2001,Bicycle,161,15,176
GUJARAT,2001,Pedestrian,490,119,609
GUJARAT,2001,Others (Please Specify),265,42,307
GUJARAT,2001,Total Deaths (Persons),3750,721,4471
GUJARAT,2001,Total Truck/Lorry,908,124,1032
GUJARAT,2001,Total Bus,313,72,385
GUJARAT,2001,Total Tempo/Vans,242,59,301
GUJARAT,2001,Total Jeep,419,91,510
GUJARAT,2001,Total Car,207,54,261
GUJARAT,2002,Truck/Lorry (Government),6,0,6
GUJARAT,2002,Truck/Lorry (Private),1044,120,1164
GUJARAT,2002,Bus (Government),117,31,148
GUJARAT,2002,Bus (Private),119,32,151
GUJARAT,2002,Tempo/Vans (Government),3,1,4
GUJARAT,2002,Tempo/Vans (Private),300,72,372
GUJARAT,2002,Jeep (Government),15,0,15
GUJARAT,2002,Jeep (Private),418,93,511
GUJARAT,2002,Car (Government),2,0,2
GUJARAT,2002,Car (Private),212,51,263
GUJARAT,2002,Three Wheeler,294,55,349
GUJARAT,2002,Two Wheeler,563,88,651
GUJARAT,2002,Bicycle,136,9,145
GUJARAT,2002,Pedestrian,523,98,621
GUJARAT,2002,Others (Please Specify),260,53,313
GUJARAT,2002,Total Deaths (Persons),4012,703,4715
GUJARAT,2002,Total Truck/Lorry,1050,120,1170
GUJARAT,2002,Total Bus,236,63,299
GUJARAT,2002,Total Tempo/Vans,303,73,376
GUJARAT,2002,Total Jeep,433,93,526
GUJARAT,2002,Total Car,214,51,265
GUJARAT,2003,Truck/Lorry (Government),2,0,2
GUJARAT,2003,Truck/Lorry (Private),979,147,1126
GUJARAT,2003,Bus (Government),123,38,161
GUJARAT,2003,Bus (Private),170,40,210
GUJARAT,2003,Tempo/Vans (Government),0,0,0
GUJARAT,2003,Tempo/Vans (Private),273,61,334
GUJARAT,2003,Jeep (Government),6,4,10
GUJARAT,2003,Jeep (Private),444,119,563
GUJARAT,2003,Car (Government),4,2,6
GUJARAT,2003,Car (Private),251,89,340
GUJARAT,2003,Three Wheeler,272,80,352
GUJARAT,2003,Two Wheeler,549,97,646
GUJARAT,2003,Bicycle,149,12,161
GUJARAT,2003,Pedestrian,480,82,562
GUJARAT,2003,Others (Please Specify),296,44,340
GUJARAT,2003,Total Deaths (Persons),3998,815,4813
GUJARAT,2003,Total Truck/Lorry,981,147,1128
GUJARAT,2003,Total Bus,293,78,371
GUJARAT,2003,Total Tempo/Vans,273,61,334
GUJARAT,2003,Total Jeep,450,123,573
GUJARAT,2003,Total Car,255,91,346
GUJARAT,2004,Truck/Lorry (Government),9,1,10
GUJARAT,2004,Truck/Lorry (Private),943,110,1053
GUJARAT,2004,Bus (Government),109,30,139
GUJARAT,2004,Bus (Private),109,28,137
GUJARAT,2004,Tempo/Vans (Government),2,0,2
GUJARAT,2004,Tempo/Vans (Private),258,38,296
GUJARAT,2004,Jeep (Government),7,2,9
GUJARAT,2004,Jeep (Private),527,85,612
GUJARAT,2004,Car (Government),5,0,5
GUJARAT,2004,Car (Private),302,72,374
GUJARAT,2004,Three Wheeler,352,87,439
GUJARAT,2004,Two Wheeler,721,93,814
GUJARAT,2004,Bicycle,148,9,157
GUJARAT,2004,Pedestrian,473,106,579
GUJARAT,2004,Others (Please Specify),264,58,322
GUJARAT,2004,Total Deaths (Persons),4229,719,4948
GUJARAT,2004,Total Truck/Lorry,952,111,1063
GUJARAT,2004,Total Bus,218,58,276
GUJARAT,2004,Total Tempo/Vans,260,38,298
GUJARAT,2004,Total Jeep,534,87,621
GUJARAT,2004,Total Car,307,72,379
GUJARAT,2005,Truck/Lorry (Government),118,32,150
GUJARAT,2005,Truck/Lorry (Private),896,131,1027
GUJARAT,2005,Bus (Government),113,25,138
GUJARAT,2005,Bus (Private),170,40,210
GUJARAT,2005,Tempo/Vans (Government),10,47,57
GUJARAT,2005,Tempo/Vans (Private),312,60,372
GUJARAT,2005,Jeep (Government),29,7,36
GUJARAT,2005,Jeep (Private),474,104,578
GUJARAT,2005,Car (Government),17,6,23
GUJARAT,2005,Car (Private),299,54,353
GUJARAT,2005,Three Wheeler,347,97,444
GUJARAT,2005,Two Wheeler,778,123,901
GUJARAT,2005,Bicycle,125,8,133
GUJARAT,2005,Pedestrian,505,93,598
GUJARAT,2005,Others (Please Specify),211,33,244
GUJARAT,2005,Total Deaths (Persons),4404,860,5264
GUJARAT,2005,Total Truck/Lorry,1014,163,1177
GUJARAT,2005,Total Bus,283,65,348
GUJARAT,2005,Total Tempo/Vans,322,107,429
GUJARAT,2005,Total Jeep,503,111,614
GUJARAT,2005,Total Car,316,60,376
GUJARAT,2006,Truck/Lorry (Government),6,2,8
GUJARAT,2006,Truck/Lorry (Private),1088,165,1253
GUJARAT,2006,Bus (Government),105,35,140
GUJARAT,2006,Bus (Private),185,77,262
GUJARAT,2006,Tempo/Vans (Government),5,0,5
GUJARAT,2006,Tempo/Vans (Private),293,93,386
GUJARAT,2006,Jeep (Government),20,4,24
GUJARAT,2006,Jeep (Private),545,150,695
GUJARAT,2006,Car (Government),7,3,10
GUJARAT,2006,Car (Private),290,74,364
GUJARAT,2006,Three Wheeler,362,145,507
GUJARAT,2006,Two Wheeler,799,151,950
GUJARAT,2006,Bicycle,132,10,142
GUJARAT,2006,Pedestrian,393,103,496
GUJARAT,2006,Others (Please Specify),282,75,357
GUJARAT,2006,Total Deaths (Persons),4512,1087,5599
GUJARAT,2006,Total Truck/Lorry,1094,167,1261
GUJARAT,2006,Total Bus,290,112,402
GUJARAT,2006,Total Tempo/Vans,298,93,391
GUJARAT,2006,Total Jeep,565,154,719
GUJARAT,2006,Total Car,297,77,374
GUJARAT,2007,Truck/Lorry (Government),24,10,34
GUJARAT,2007,Truck/Lorry (Private),1272,237,1509
GUJARAT,2007,Bus (Government),102,29,131
GUJARAT,2007,Bus (Private),271,91,362
GUJARAT,2007,Tempo/Vans (Government),2,0,2
GUJARAT,2007,Tempo/Vans (Private),384,97,481
GUJARAT,2007,Jeep (Government),8,2,10
GUJARAT,2007,Jeep (Private),606,164,770
GUJARAT,2007,Car (Government),3,1,4
GUJARAT,2007,Car (Private),332,91,423
GUJARAT,2007,Three Wheeler,400,88,488
GUJARAT,2007,Two Wheeler,881,176,1057
GUJARAT,2007,Bicycle,150,4,154
GUJARAT,2007,Pedestrian,457,83,540
GUJARAT,2007,Others (Please Specify),280,48,328
GUJARAT,2007,Total Deaths (Persons),5172,1121,6293
GUJARAT,2007,Total Truck/Lorry,1296,247,1543
GUJARAT,2007,Total Bus,373,120,493
GUJARAT,2007,Total Tempo/Vans,386,97,483
GUJARAT,2007,Total Jeep,614,166,780
GUJARAT,2007,Total Car,335,92,427
GUJARAT,2008,Truck/Lorry (Government),32,3,35
GUJARAT,2008,Truck/Lorry (Private),1229,192,1421
GUJARAT,2008,Bus (Government),136,67,203
GUJARAT,2008,Bus (Private),236,52,288
GUJARAT,2008,Tempo/Vans (Government),1,0,1
GUJARAT,2008,Tempo/Vans (Private),366,69,435
GUJARAT,2008,Jeep (Government),3,1,4
GUJARAT,2008,Jeep (Private),655,141,796
GUJARAT,2008,Car (Government),4,1,5
GUJARAT,2008,Car (Private),364,107,471
GUJARAT,2008,Three Wheeler,391,106,497
GUJARAT,2008,Two Wheeler,947,155,1102
GUJARAT,2008,Bicycle,150,11,161
GUJARAT,2008,Pedestrian,545,95,640
GUJARAT,2008,Others (Please Specify),277,50,327
GUJARAT,2008,Total Deaths (Persons),5336,1050,6386
GUJARAT,2008,Total Truck/Lorry,1261,195,1456
GUJARAT,2008,Total Bus,372,119,491
GUJARAT,2008,Total Tempo/Vans,367,69,436
GUJARAT,2008,Total Jeep,658,142,800
GUJARAT,2008,Total Car,368,108,476
GUJARAT,2009,Truck/Lorry (Government),5,0,5
GUJARAT,2009,Truck/Lorry (Private),1202,177,1379
GUJARAT,2009,Bus (Government),76,25,101
GUJARAT,2009,Bus (Private),237,67,304
GUJARAT,2009,Tempo/Vans (Government),12,0,12
GUJARAT,2009,Tempo/Vans (Private),405,78,483
GUJARAT,2009,Jeep (Government),6,1,7
GUJARAT,2009,Jeep (Private),712,225,937
GUJARAT,2009,Car (Government),3,1,4
GUJARAT,2009,Car (Private),552,103,655
GUJARAT,2009,Three Wheeler,409,146,555
GUJARAT,2009,Two Wheeler,1069,191,1260
GUJARAT,2009,Bicycle,140,15,155
GUJARAT,2009,Pedestrian,528,99,627
GUJARAT,2009,Others (Please Specify),351,79,430
GUJARAT,2009,Total Deaths (Persons),5707,1207,6914
GUJARAT,2009,Total Truck/Lorry,1207,177,1384
GUJARAT,2009,Total Bus,313,92,405
GUJARAT,2009,Total Tempo/Vans,417,78,495
GUJARAT,2009,Total Jeep,718,226,944
GUJARAT,2009,Total Car,555,104,659
GUJARAT,2010,Truck/Lorry (Government),9,1,10
GUJARAT,2010,Truck/Lorry (Private),1291,177,1468
GUJARAT,2010,Bus (Government),90,14,104
GUJARAT,2010,Bus (Private),310,72,382
GUJARAT,2010,Tempo/Vans (Government),4,0,4
GUJARAT,2010,Tempo/Vans (Private),384,84,468
GUJARAT,2010,Jeep (Government),6,2,8
GUJARAT,2010,Jeep (Private),642,153,795
GUJARAT,2010,Car (Government),2,1,3
GUJARAT,2010,Car (Private),630,107,737
GUJARAT,2010,Three Wheeler,534,126,660
GUJARAT,2010,Two Wheeler,1197,206,1403
GUJARAT,2010,Bicycle,147,16,163
GUJARAT,2010,Pedestrian,594,97,691
GUJARAT,2010,Others (Please Specify),413,75,488
GUJARAT,2010,Total Deaths (Persons),6253,1131,7384
GUJARAT,2010,Total Truck/Lorry,1300,178,1478
GUJARAT,2010,Total Bus,400,86,486
GUJARAT,2010,Total Tempo/Vans,388,84,472
GUJARAT,2010,Total Jeep,648,155,803
GUJARAT,2010,Total Car,632,108,740
GUJARAT,2011,Truck/Lorry (Government),12,1,13
GUJARAT,2011,Truck/Lorry (Private),1484,213,1697
GUJARAT,2011,Bus (Government),142,30,172
GUJARAT,2011,Bus (Private),353,73,426
GUJARAT,2011,Tempo/Vans (Government),16,0,16
GUJARAT,2011,Tempo/Vans (Private),381,90,471
GUJARAT,2011,Jeep (Government),17,2,19
GUJARAT,2011,Jeep (Private),642,149,791
GUJARAT,2011,Car (Government),6,0,6
GUJARAT,2011,Car (Private),651,159,810
GUJARAT,2011,Three Wheeler,598,139,737
GUJARAT,2011,Two Wheeler,1228,239,1467
GUJARAT,2011,Bicycle,168,15,183
GUJARAT,2011,Pedestrian,512,113,625
GUJARAT,2011,Others (Please Specify),470,103,573
GUJARAT,2011,Total Deaths (Persons),6680,1326,8006
GUJARAT,2011,Total Truck/Lorry,1496,214,1710
GUJARAT,2011,Total Bus,495,103,598
GUJARAT,2011,Total Tempo/Vans,397,90,487
GUJARAT,2011,Total Jeep,659,151,810
GUJARAT,2011,Total Car,657,159,816
GUJARAT,2012,Truck/Lorry (Government),12,5,17
GUJARAT,2012,Truck/Lorry (Private),1409,231,1640
GUJARAT,2012,Bus (Government),79,21,100
GUJARAT,2012,Bus (Private),329,84,413
GUJARAT,2012,Tempo/Vans (Government),4,0,4
GUJARAT,2012,Tempo/Vans (Private),525,91,616
GUJARAT,2012,Jeep (Government),22,4,26
GUJARAT,2012,Jeep (Private),620,147,767
GUJARAT,2012,Car (Government),26,0,26
GUJARAT,2012,Car (Private),740,147,887
GUJARAT,2012,Three Wheeler,579,128,707
GUJARAT,2012,Two Wheeler,1351,200,1551
GUJARAT,2012,Bicycle,92,8,100
GUJARAT,2012,Pedestrian,410,83,493
GUJARAT,2012,Others (Please Specify),441,67,508
GUJARAT,2012,Total Deaths (Persons),6639,1216,7855
GUJARAT,2012,Total Truck/Lorry,1421,236,1657
GUJARAT,2012,Total Bus,408,105,513
GUJARAT,2012,Total Tempo/Vans,529,91,620
GUJARAT,2012,Total Jeep,642,151,793
GUJARAT,2012,Total Car,766,147,913
HARYANA,2001,Truck/Lorry (Government),5,0,5
HARYANA,2001,Truck/Lorry (Private),512,46,558
HARYANA,2001,Bus (Government),120,28,148
HARYANA,2001,Bus (Private),72,16,88
HARYANA,2001,Tempo/Vans (Government),22,3,25
HARYANA,2001,Tempo/Vans (Private),89,18,107
HARYANA,2001,Jeep (Government),32,3,35
HARYANA,2001,Jeep (Private),168,26,194
HARYANA,2001,Car (Government),2,2,4
HARYANA,2001,Car (Private),199,47,246
HARYANA,2001,Three Wheeler,86,28,114
HARYANA,2001,Two Wheeler,215,43,258
HARYANA,2001,Bicycle,145,22,167
HARYANA,2001,Pedestrian,270,9,279
HARYANA,2001,Others (Please Specify),288,52,340
HARYANA,2001,Total Deaths (Persons),2225,343,2568
HARYANA,2001,Total Truck/Lorry,517,46,563
HARYANA,2001,Total Bus,192,44,236
HARYANA,2001,Total Tempo/Vans,111,21,132
HARYANA,2001,Total Jeep,200,29,229
HARYANA,2001,Total Car,201,49,250
HARYANA,2002,Truck/Lorry (Government),5,0,5
HARYANA,2002,Truck/Lorry (Private),506,41,547
HARYANA,2002,Bus (Government),85,22,107
HARYANA,2002,Bus (Private),63,11,74
HARYANA,2002,Tempo/Vans (Government),3,1,4
HARYANA,2002,Tempo/Vans (Private),269,25,294
HARYANA,2002,Jeep (Government),2,2,4
HARYANA,2002,Jeep (Private),181,27,208
HARYANA,2002,Car (Government),1,0,1
HARYANA,2002,Car (Private),137,26,163
HARYANA,2002,Three Wheeler,75,24,99
HARYANA,2002,Two Wheeler,273,58,331
HARYANA,2002,Bicycle,50,8,58
HARYANA,2002,Pedestrian,191,46,237
HARYANA,2002,Others (Please Specify),261,41,302
HARYANA,2002,Total Deaths (Persons),2102,332,2434
HARYANA,2002,Total Truck/Lorry,511,41,552
HARYANA,2002,Total Bus,148,33,181
HARYANA,2002,Total Tempo/Vans,272,26,298
HARYANA,2002,Total Jeep,183,29,212
HARYANA,2002,Total Car,138,26,164
HARYANA,2003,Truck/Lorry (Government),355,5,360
HARYANA,2003,Truck/Lorry (Private),408,45,453
HARYANA,2003,Bus (Government),115,18,133
HARYANA,2003,Bus (Private),37,9,46
HARYANA,2003,Tempo/Vans (Government),2,0,2
HARYANA,2003,Tempo/Vans (Private),84,19,103
HARYANA,2003,Jeep (Government),1,1,2
HARYANA,2003,Jeep (Private),275,45,320
HARYANA,2003,Car (Government),0,0,0
HARYANA,2003,Car (Private),186,47,233
HARYANA,2003,Three Wheeler,101,20,121
HARYANA,2003,Two Wheeler,356,66,422
HARYANA,2003,Bicycle,87,10,97
HARYANA,2003,Pedestrian,255,34,289
HARYANA,2003,Others (Please Specify),301,31,332
HARYANA,2003,Total Deaths (Persons),2563,350,2913
HARYANA,2003,Total Truck/Lorry,763,50,813
HARYANA,2003,Total Bus,152,27,179
HARYANA,2003,Total Tempo/Vans,86,19,105
HARYANA,2003,Total Jeep,276,46,322
HARYANA,2003,Total Car,186,47,233
HARYANA,2004,Truck/Lorry (Government),15,0,15
HARYANA,2004,Truck/Lorry (Private),816,87,903
HARYANA,2004,Bus (Government),142,29,171
HARYANA,2004,Bus (Private),74,15,89
HARYANA,2004,Tempo/Vans (Government),12,1,13
HARYANA,2004,Tempo/Vans (Private),185,31,216
HARYANA,2004,Jeep (Government),1,0,1
HARYANA,2004,Jeep (Private),251,52,303
HARYANA,2004,Car (Government),4,0,4
HARYANA,2004,Car (Private),254,43,297
HARYANA,2004,Three Wheeler,93,18,111
HARYANA,2004,Two Wheeler,307,34,341
HARYANA,2004,Bicycle,64,9,73
HARYANA,2004,Pedestrian,254,42,296
HARYANA,2004,Others (Please Specify),392,28,420
HARYANA,2004,Total Deaths (Persons),2864,389,3253
HARYANA,2004,Total Truck/Lorry,831,87,918
HARYANA,2004,Total Bus,216,44,260
HARYANA,2004,Total Tempo/Vans,197,32,229
HARYANA,2004,Total Jeep,252,52,304
HARYANA,2004,Total Car,258,43,301
HARYANA,2005,Truck/Lorry (Government),138,4,142
HARYANA,2005,Truck/Lorry (Private),432,28,460
HARYANA,2005,Bus (Government),75,20,95
HARYANA,2005,Bus (Private),86,14,100
HARYANA,2005,Tempo/Vans (Government),15,3,18
HARYANA,2005,Tempo/Vans (Private),135,17,152
HARYANA,2005,Jeep (Government),2,1,3
HARYANA,2005,Jeep (Private),247,29,276
HARYANA,2005,Car (Government),8,1,9
HARYANA,2005,Car (Private),290,50,340
HARYANA,2005,Three Wheeler,110,23,133
HARYANA,2005,Two Wheeler,431,54,485
HARYANA,2005,Bicycle,74,4,78
HARYANA,2005,Pedestrian,244,56,300
HARYANA,2005,Others (Please Specify),619,72,691
HARYANA,2005,Total Deaths (Persons),2906,376,3282
HARYANA,2005,Total Truck/Lorry,570,32,602
HARYANA,2005,Total Bus,161,34,195
HARYANA,2005,Total Tempo/Vans,150,20,170
HARYANA,2005,Total Jeep,249,30,279
HARYANA,2005,Total Car,298,51,349
HARYANA,2006,Truck/Lorry (Government),67,4,71
HARYANA,2006,Truck/Lorry (Private),634,47,681
HARYANA,2006,Bus (Government),113,21,134
HARYANA,2006,Bus (Private),112,25,137
HARYANA,2006,Tempo/Vans (Government),7,5,12
HARYANA,2006,Tempo/Vans (Private),189,47,236
HARYANA,2006,Jeep (Government),8,1,9
HARYANA,2006,Jeep (Private),365,72,437
HARYANA,2006,Car (Government),17,0,17
HARYANA,2006,Car (Private),429,77,506
HARYANA,2006,Three Wheeler,237,46,283
HARYANA,2006,Two Wheeler,626,99,725
HARYANA,2006,Bicycle,174,25,199
HARYANA,2006,Pedestrian,323,27,350
HARYANA,2006,Others (Please Specify),551,72,623
HARYANA,2006,Total Deaths (Persons),3852,568,4420
HARYANA,2006,Total Truck/Lorry,701,51,752
HARYANA,2006,Total Bus,225,46,271
HARYANA,2006,Total Tempo/Vans,196,52,248
HARYANA,2006,Total Jeep,373,73,446
HARYANA,2006,Total Car,446,77,523
HARYANA,2007,Truck/Lorry (Government),22,2,24
HARYANA,2007,Truck/Lorry (Private),657,40,697
HARYANA,2007,Bus (Government),96,15,111
HARYANA,2007,Bus (Private),130,22,152
HARYANA,2007,Tempo/Vans (Government),6,2,8
HARYANA,2007,Tempo/Vans (Private),252,22,274
HARYANA,2007,Jeep (Government),15,3,18
HARYANA,2007,Jeep (Private),430,41,471
HARYANA,2007,Car (Government),15,6,21
HARYANA,2007,Car (Private),584,68,652
HARYANA,2007,Three Wheeler,230,36,266
HARYANA,2007,Two Wheeler,702,79,781
HARYANA,2007,Bicycle,95,4,99
HARYANA,2007,Pedestrian,356,56,412
HARYANA,2007,Others (Please Specify),349,41,390
HARYANA,2007,Total Deaths (Persons),3939,437,4376
HARYANA,2007,Total Truck/Lorry,679,42,721
HARYANA,2007,Total Bus,226,37,263
HARYANA,2007,Total Tempo/Vans,258,24,282
HARYANA,2007,Total Jeep,445,44,489
HARYANA,2007,Total Car,599,74,673
HARYANA,2008,Truck/Lorry (Government),0,0,0
HARYANA,2008,Truck/Lorry (Private),831,61,892
HARYANA,2008,Bus (Government),136,23,159
HARYANA,2008,Bus (Private),120,26,146
HARYANA,2008,Tempo/Vans (Government),0,0,0
HARYANA,2008,Tempo/Vans (Private),310,37,347
HARYANA,2008,Jeep (Government),4,3,7
HARYANA,2008,Jeep (Private),419,47,466
HARYANA,2008,Car (Government),0,0,0
HARYANA,2008,Car (Private),586,55,641
HARYANA,2008,Three Wheeler,256,38,294
HARYANA,2008,Two Wheeler,572,76,648
HARYANA,2008,Bicycle,119,5,124
HARYANA,2008,Pedestrian,421,40,461
HARYANA,2008,Others (Please Specify),440,55,495
HARYANA,2008,Total Deaths (Persons),4214,466,4680
HARYANA,2008,Total Truck/Lorry,831,61,892
HARYANA,2008,Total Bus,256,49,305
HARYANA,2008,Total Tempo/Vans,310,37,347
HARYANA,2008,Total Jeep,423,50,473
HARYANA,2008,Total Car,586,55,641
HARYANA,2009,Truck/Lorry (Government),32,6,38
HARYANA,2009,Truck/Lorry (Private),680,49,729
HARYANA,2009,Bus (Government),191,27,218
HARYANA,2009,Bus (Private),167,22,189
HARYANA,2009,Tempo/Vans (Government),84,7,91
HARYANA,2009,Tempo/Vans (Private),186,22,208
HARYANA,2009,Jeep (Government),6,0,6
HARYANA,2009,Jeep (Private),344,68,412
HARYANA,2009,Car (Government),0,0,0
HARYANA,2009,Car (Private),448,74,522
HARYANA,2009,Three Wheeler,208,44,252
HARYANA,2009,Two Wheeler,743,95,838
HARYANA,2009,Bicycle,109,4,113
HARYANA,2009,Pedestrian,569,90,659
HARYANA,2009,Others (Please Specify),542,49,591
HARYANA,2009,Total Deaths (Persons),4309,557,4866
HARYANA,2009,Total Truck/Lorry,712,55,767
HARYANA,2009,Total Bus,358,49,407
HARYANA,2009,Total Tempo/Vans,270,29,299
HARYANA,2009,Total Jeep,350,68,418
HARYANA,2009,Total Car,448,74,522
HARYANA,2010,Truck/Lorry (Government),38,0,38
HARYANA,2010,Truck/Lorry (Private),623,61,684
HARYANA,2010,Bus (Government),94,17,111
HARYANA,2010,Bus (Private),268,26,294
HARYANA,2010,Tempo/Vans (Government),4,0,4
HARYANA,2010,Tempo/Vans (Private),336,46,382
HARYANA,2010,Jeep (Government),2,0,2
HARYANA,2010,Jeep (Private),334,68,402
HARYANA,2010,Car (Government),20,2,22
HARYANA,2010,Car (Private),468,87,555
HARYANA,2010,Three Wheeler,169,37,206
HARYANA,2010,Two Wheeler,630,99,729
HARYANA,2010,Bicycle,109,11,120
HARYANA,2010,Pedestrian,534,70,604
HARYANA,2010,Others (Please Specify),722,131,853
HARYANA,2010,Total Deaths (Persons),4351,655,5006
HARYANA,2010,Total Truck/Lorry,661,61,722
HARYANA,2010,Total Bus,362,43,405
HARYANA,2010,Total Tempo/Vans,340,46,386
HARYANA,2010,Total Jeep,336,68,404
HARYANA,2010,Total Car,488,89,577
HARYANA,2011,Truck/Lorry (Government),42,2,44
HARYANA,2011,Truck/Lorry (Private),623,62,685
HARYANA,2011,Bus (Government),95,18,113
HARYANA,2011,Bus (Private),105,20,125
HARYANA,2011,Tempo/Vans (Government),2,0,2
HARYANA,2011,Tempo/Vans (Private),232,49,281
HARYANA,2011,Jeep (Government),4,1,5
HARYANA,2011,Jeep (Private),372,43,415
HARYANA,2011,Car (Government),18,1,19
HARYANA,2011,Car (Private),478,69,547
HARYANA,2011,Three Wheeler,156,24,180
HARYANA,2011,Two Wheeler,864,61,925
HARYANA,2011,Bicycle,95,1,96
HARYANA,2011,Pedestrian,662,36,698
HARYANA,2011,Others (Please Specify),517,29,546
HARYANA,2011,Total Deaths (Persons),4265,416,4681
HARYANA,2011,Total Truck/Lorry,665,64,729
HARYANA,2011,Total Bus,200,38,238
HARYANA,2011,Total Tempo/Vans,234,49,283
HARYANA,2011,Total Jeep,376,44,420
HARYANA,2011,Total Car,496,70,566
HARYANA,2012,Truck/Lorry (Government),4,0,4
HARYANA,2012,Truck/Lorry (Private),619,50,669
HARYANA,2012,Bus (Government),103,16,119
HARYANA,2012,Bus (Private),121,27,148
HARYANA,2012,Tempo/Vans (Government),0,0,0
HARYANA,2012,Tempo/Vans (Private),210,32,242
HARYANA,2012,Jeep (Government),4,1,5
HARYANA,2012,Jeep (Private),396,48,444
HARYANA,2012,Car (Government),0,1,1
HARYANA,2012,Car (Private),516,69,585
HARYANA,2012,Three Wheeler,239,46,285
HARYANA,2012,Two Wheeler,805,100,905
HARYANA,2012,Bicycle,100,0,100
HARYANA,2012,Pedestrian,556,46,602
HARYANA,2012,Others (Please Specify),460,29,489
HARYANA,2012,Total Deaths (Persons),4133,465,4598
HARYANA,2012,Total Truck/Lorry,623,50,673
HARYANA,2012,Total Bus,224,43,267
HARYANA,2012,Total Tempo/Vans,210,32,242
HARYANA,2012,Total Jeep,400,49,449
HARYANA,2012,Total Car,516,70,586
HIMACHAL PRADESH,2001,Truck/Lorry (Government),1,0,1
HIMACHAL PRADESH,2001,Truck/Lorry (Private),159,15,174
HIMACHAL PRADESH,2001,Bus (Government),55,7,62
HIMACHAL PRADESH,2001,Bus (Private),83,23,106
HIMACHAL PRADESH,2001,Tempo/Vans (Government),0,2,2
HIMACHAL PRADESH,2001,Tempo/Vans (Private),70,8,78
HIMACHAL PRADESH,2001,Jeep (Government),0,0,0
HIMACHAL PRADESH,2001,Jeep (Private),78,13,91
HIMACHAL PRADESH,2001,Car (Government),1,0,1
HIMACHAL PRADESH,2001,Car (Private),76,10,86
HIMACHAL PRADESH,2001,Three Wheeler,6,0,6
HIMACHAL PRADESH,2001,Two Wheeler,53,1,54
HIMACHAL PRADESH,2001,Bicycle,2,0,2
HIMACHAL PRADESH,2001,Pedestrian,29,10,39
HIMACHAL PRADESH,2001,Others (Please Specify),56,5,61
HIMACHAL PRADESH,2001,Total Deaths (Persons),669,94,763
HIMACHAL PRADESH,2001,Total Truck/Lorry,160,15,175
HIMACHAL PRADESH,2001,Total Bus,138,30,168
HIMACHAL PRADESH,2001,Total Tempo/Vans,70,10,80
HIMACHAL PRADESH,2001,Total Jeep,78,13,91
HIMACHAL PRADESH,2001,Total Car,77,10,87
HIMACHAL PRADESH,2002,Truck/Lorry (Government),5,0,5
HIMACHAL PRADESH,2002,Truck/Lorry (Private),160,10,170
HIMACHAL PRADESH,2002,Bus (Government),30,5,35
HIMACHAL PRADESH,2002,Bus (Private),122,50,172
HIMACHAL PRADESH,2002,Tempo/Vans (Government),2,0,2
HIMACHAL PRADESH,2002,Tempo/Vans (Private),65,7,72
HIMACHAL PRADESH,2002,Jeep (Government),0,1,1
HIMACHAL PRADESH,2002,Jeep (Private),82,5,87
HIMACHAL PRADESH,2002,Car (Government),0,0,0
HIMACHAL PRADESH,2002,Car (Private),83,12,95
HIMACHAL PRADESH,2002,Three Wheeler,7,1,8
HIMACHAL PRADESH,2002,Two Wheeler,69,7,76
HIMACHAL PRADESH,2002,Bicycle,4,0,4
HIMACHAL PRADESH,2002,Pedestrian,14,1,15
HIMACHAL PRADESH,2002,Others (Please Specify),92,4,96
HIMACHAL PRADESH,2002,Total Deaths (Persons),735,103,838
HIMACHAL PRADESH,2002,Total Truck/Lorry,165,10,175
HIMACHAL PRADESH,2002,Total Bus,152,55,207
HIMACHAL PRADESH,2002,Total Tempo/Vans,67,7,74
HIMACHAL PRADESH,2002,Total Jeep,82,6,88
HIMACHAL PRADESH,2002,Total Car,83,12,95
HIMACHAL PRADESH,2003,Truck/Lorry (Government),4,0,4
HIMACHAL PRADESH,2003,Truck/Lorry (Private),132,6,138
HIMACHAL PRADESH,2003,Bus (Government),68,9,77
HIMACHAL PRADESH,2003,Bus (Private),54,10,64
HIMACHAL PRADESH,2003,Tempo/Vans (Government),0,0,0
HIMACHAL PRADESH,2003,Tempo/Vans (Private),66,25,91
HIMACHAL PRADESH,2003,Jeep (Government),3,0,3
HIMACHAL PRADESH,2003,Jeep (Private),94,14,108
HIMACHAL PRADESH,2003,Car (Government),5,0,5
HIMACHAL PRADESH,2003,Car (Private),88,14,102
HIMACHAL PRADESH,2003,Three Wheeler,7,1,8
HIMACHAL PRADESH,2003,Two Wheeler,70,7,77
HIMACHAL PRADESH,2003,Bicycle,10,0,10
HIMACHAL PRADESH,2003,Pedestrian,41,9,50
HIMACHAL PRADESH,2003,Others (Please Specify),36,4,40
HIMACHAL PRADESH,2003,Total Deaths (Persons),678,99,777
HIMACHAL PRADESH,2003,Total Truck/Lorry,136,6,142
HIMACHAL PRADESH,2003,Total Bus,122,19,141
HIMACHAL PRADESH,2003,Total Tempo/Vans,66,25,91
HIMACHAL PRADESH,2003,Total Jeep,97,14,111
HIMACHAL PRADESH,2003,Total Car,93,14,107
HIMACHAL PRADESH,2004,Truck/Lorry (Government),14,0,14
HIMACHAL PRADESH,2004,Truck/Lorry (Private),132,7,139
HIMACHAL PRADESH,2004,Bus (Government),50,20,70
HIMACHAL PRADESH,2004,Bus (Private),111,41,152
HIMACHAL PRADESH,2004,Tempo/Vans (Government),0,1,1
HIMACHAL PRADESH,2004,Tempo/Vans (Private),94,14,108
HIMACHAL PRADESH,2004,Jeep (Government),0,0,0
HIMACHAL PRADESH,2004,Jeep (Private),96,14,110
HIMACHAL PRADESH,2004,Car (Government),0,0,0
HIMACHAL PRADESH,2004,Car (Private),138,20,158
HIMACHAL PRADESH,2004,Three Wheeler,9,0,9
HIMACHAL PRADESH,2004,Two Wheeler,84,6,90
HIMACHAL PRADESH,2004,Bicycle,4,0,4
HIMACHAL PRADESH,2004,Pedestrian,16,2,18
HIMACHAL PRADESH,2004,Others (Please Specify),55,6,61
HIMACHAL PRADESH,2004,Total Deaths (Persons),803,131,934
HIMACHAL PRADESH,2004,Total Truck/Lorry,146,7,153
HIMACHAL PRADESH,2004,Total Bus,161,61,222
HIMACHAL PRADESH,2004,Total Tempo/Vans,94,15,109
HIMACHAL PRADESH,2004,Total Jeep,96,14,110
HIMACHAL PRADESH,2004,Total Car,138,20,158
HIMACHAL PRADESH,2005,Truck/Lorry (Government),17,0,17
HIMACHAL PRADESH,2005,Truck/Lorry (Private),118,19,137
HIMACHAL PRADESH,2005,Bus (Government),22,5,27
HIMACHAL PRADESH,2005,Bus (Private),90,27,117
HIMACHAL PRADESH,2005,Tempo/Vans (Government),0,2,2
HIMACHAL PRADESH,2005,Tempo/Vans (Private),29,3,32
HIMACHAL PRADESH,2005,Jeep (Government),9,0,9
HIMACHAL PRADESH,2005,Jeep (Private),135,21,156
HIMACHAL PRADESH,2005,Car (Government),7,0,7
HIMACHAL PRADESH,2005,Car (Private),104,22,126
HIMACHAL PRADESH,2005,Three Wheeler,8,1,9
HIMACHAL PRADESH,2005,Two Wheeler,73,10,83
HIMACHAL PRADESH,2005,Bicycle,1,0,1
HIMACHAL PRADESH,2005,Pedestrian,21,3,24
HIMACHAL PRADESH,2005,Others (Please Specify),100,7,107
HIMACHAL PRADESH,2005,Total Deaths (Persons),734,120,854
HIMACHAL PRADESH,2005,Total Truck/Lorry,135,19,154
HIMACHAL PRADESH,2005,Total Bus,112,32,144
HIMACHAL PRADESH,2005,Total Tempo/Vans,29,5,34
HIMACHAL PRADESH,2005,Total Jeep,144,21,165
HIMACHAL PRADESH,2005,Total Car,111,22,133
HIMACHAL PRADESH,2006,Truck/Lorry (Government),6,0,6
HIMACHAL PRADESH,2006,Truck/Lorry (Private),86,9,95
HIMACHAL PRADESH,2006,Bus (Government),50,12,62
HIMACHAL PRADESH,2006,Bus (Private),62,25,87
HIMACHAL PRADESH,2006,Tempo/Vans (Government),2,0,2
HIMACHAL PRADESH,2006,Tempo/Vans (Private),72,4,76
HIMACHAL PRADESH,2006,Jeep (Government),18,6,24
HIMACHAL PRADESH,2006,Jeep (Private),94,18,112
HIMACHAL PRADESH,2006,Car (Government),0,0,0
HIMACHAL PRADESH,2006,Car (Private),125,42,167
HIMACHAL PRADESH,2006,Three Wheeler,17,2,19
HIMACHAL PRADESH,2006,Two Wheeler,81,9,90
HIMACHAL PRADESH,2006,Bicycle,3,0,3
HIMACHAL PRADESH,2006,Pedestrian,13,1,14
HIMACHAL PRADESH,2006,Others (Please Specify),116,17,133
HIMACHAL PRADESH,2006,Total Deaths (Persons),745,145,890
HIMACHAL PRADESH,2006,Total Truck/Lorry,92,9,101
HIMACHAL PRADESH,2006,Total Bus,112,37,149
HIMACHAL PRADESH,2006,Total Tempo/Vans,74,4,78
HIMACHAL PRADESH,2006,Total Jeep,112,24,136
HIMACHAL PRADESH,2006,Total Car,125,42,167
HIMACHAL PRADESH,2007,Truck/Lorry (Government),21,4,25
HIMACHAL PRADESH,2007,Truck/Lorry (Private),133,4,137
HIMACHAL PRADESH,2007,Bus (Government),32,6,38
HIMACHAL PRADESH,2007,Bus (Private),101,31,132
HIMACHAL PRADESH,2007,Tempo/Vans (Government),0,0,0
HIMACHAL PRADESH,2007,Tempo/Vans (Private),38,4,42
HIMACHAL PRADESH,2007,Jeep (Government),14,3,17
HIMACHAL PRADESH,2007,Jeep (Private),139,18,157
HIMACHAL PRADESH,2007,Car (Government),4,0,4
HIMACHAL PRADESH,2007,Car (Private),112,24,136
HIMACHAL PRADESH,2007,Three Wheeler,0,0,0
HIMACHAL PRADESH,2007,Two Wheeler,104,8,112
HIMACHAL PRADESH,2007,Bicycle,3,0,3
HIMACHAL PRADESH,2007,Pedestrian,15,1,16
HIMACHAL PRADESH,2007,Others (Please Specify),165,13,178
HIMACHAL PRADESH,2007,Total Deaths (Persons),881,116,997
HIMACHAL PRADESH,2007,Total Truck/Lorry,154,8,162
HIMACHAL PRADESH,2007,Total Bus,133,37,170
HIMACHAL PRADESH,2007,Total Tempo/Vans,38,4,42
HIMACHAL PRADESH,2007,Total Jeep,153,21,174
HIMACHAL PRADESH,2007,Total Car,116,24,140
HIMACHAL PRADESH,2008,Truck/Lorry (Government),0,0,0
HIMACHAL PRADESH,2008,Truck/Lorry (Private),110,7,117
HIMACHAL PRADESH,2008,Bus (Government),27,5,32
HIMACHAL PRADESH,2008,Bus (Private),88,17,105
HIMACHAL PRADESH,2008,Tempo/Vans (Government),0,0,0
HIMACHAL PRADESH,2008,Tempo/Vans (Private),42,7,49
HIMACHAL PRADESH,2008,Jeep (Government),23,2,25
HIMACHAL PRADESH,2008,Jeep (Private),90,13,103
HIMACHAL PRADESH,2008,Car (Government),0,0,0
HIMACHAL PRADESH,2008,Car (Private),103,13,116
HIMACHAL PRADESH,2008,Three Wheeler,3,1,4
HIMACHAL PRADESH,2008,Two Wheeler,87,7,94
HIMACHAL PRADESH,2008,Bicycle,2,0,2
HIMACHAL PRADESH,2008,Pedestrian,34,9,43
HIMACHAL PRADESH,2008,Others (Please Specify),103,5,108
HIMACHAL PRADESH,2008,Total Deaths (Persons),712,86,798
HIMACHAL PRADESH,2008,Total Truck/Lorry,110,7,117
HIMACHAL PRADESH,2008,Total Bus,115,22,137
HIMACHAL PRADESH,2008,Total Tempo/Vans,42,7,49
HIMACHAL PRADESH,2008,Total Jeep,113,15,128
HIMACHAL PRADESH,2008,Total Car,103,13,116
HIMACHAL PRADESH,2009,Truck/Lorry (Government),1,0,1
HIMACHAL PRADESH,2009,Truck/Lorry (Private),177,11,188
HIMACHAL PRADESH,2009,Bus (Government),24,6,30
HIMACHAL PRADESH,2009,Bus (Private),137,63,200
HIMACHAL PRADESH,2009,Tempo/Vans (Government),2,0,2
HIMACHAL PRADESH,2009,Tempo/Vans (Private),75,13,88
HIMACHAL PRADESH,2009,Jeep (Government),0,0,0
HIMACHAL PRADESH,2009,Jeep (Private),137,20,157
HIMACHAL PRADESH,2009,Car (Government),0,0,0
HIMACHAL PRADESH,2009,Car (Private),152,23,175
HIMACHAL PRADESH,2009,Three Wheeler,2,0,2
HIMACHAL PRADESH,2009,Two Wheeler,108,21,129
HIMACHAL PRADESH,2009,Bicycle,1,0,1
HIMACHAL PRADESH,2009,Pedestrian,22,4,26
HIMACHAL PRADESH,2009,Others (Please Specify),102,11,113
HIMACHAL PRADESH,2009,Total Deaths (Persons),940,172,1112
HIMACHAL PRADESH,2009,Total Truck/Lorry,178,11,189
HIMACHAL PRADESH,2009,Total Bus,161,69,230
HIMACHAL PRADESH,2009,Total Tempo/Vans,77,13,90
HIMACHAL PRADESH,2009,Total Jeep,137,20,157
HIMACHAL PRADESH,2009,Total Car,152,23,175
HIMACHAL PRADESH,2010,Truck/Lorry (Government),0,0,0
HIMACHAL PRADESH,2010,Truck/Lorry (Private),185,45,230
HIMACHAL PRADESH,2010,Bus (Government),31,4,35
HIMACHAL PRADESH,2010,Bus (Private),76,15,91
HIMACHAL PRADESH,2010,Tempo/Vans (Government),0,0,0
HIMACHAL PRADESH,2010,Tempo/Vans (Private),96,11,107
HIMACHAL PRADESH,2010,Jeep (Government),2,0,2
HIMACHAL PRADESH,2010,Jeep (Private),80,15,95
HIMACHAL PRADESH,2010,Car (Government),0,0,0
HIMACHAL PRADESH,2010,Car (Private),196,33,229
HIMACHAL PRADESH,2010,Three Wheeler,8,1,9
HIMACHAL PRADESH,2010,Two Wheeler,120,14,134
HIMACHAL PRADESH,2010,Bicycle,0,0,0
HIMACHAL PRADESH,2010,Pedestrian,17,3,20
HIMACHAL PRADESH,2010,Others (Please Specify),131,16,147
HIMACHAL PRADESH,2010,Total Deaths (Persons),942,157,1099
HIMACHAL PRADESH,2010,Total Truck/Lorry,185,45,230
HIMACHAL PRADESH,2010,Total Bus,107,19,126
HIMACHAL PRADESH,2010,Total Tempo/Vans,96,11,107
HIMACHAL PRADESH,2010,Total Jeep,82,15,97
HIMACHAL PRADESH,2010,Total Car,196,33,229
HIMACHAL PRADESH,2011,Truck/Lorry (Government),3,0,3
HIMACHAL PRADESH,2011,Truck/Lorry (Private),132,16,148
HIMACHAL PRADESH,2011,Bus (Government),47,10,57
HIMACHAL PRADESH,2011,Bus (Private),60,20,80
HIMACHAL PRADESH,2011,Tempo/Vans (Government),1,0,1
HIMACHAL PRADESH,2011,Tempo/Vans (Private),65,6,71
HIMACHAL PRADESH,2011,Jeep (Government),0,0,0
HIMACHAL PRADESH,2011,Jeep (Private),115,16,131
HIMACHAL PRADESH,2011,Car (Government),0,0,0
HIMACHAL PRADESH,2011,Car (Private),236,43,279
HIMACHAL PRADESH,2011,Three Wheeler,4,4,8
HIMACHAL PRADESH,2011,Two Wheeler,130,17,147
HIMACHAL PRADESH,2011,Bicycle,0,0,0
HIMACHAL PRADESH,2011,Pedestrian,19,4,23
HIMACHAL PRADESH,2011,Others (Please Specify),114,21,135
HIMACHAL PRADESH,2011,Total Deaths (Persons),926,157,1083
HIMACHAL PRADESH,2011,Total Truck/Lorry,135,16,151
HIMACHAL PRADESH,2011,Total Bus,107,30,137
HIMACHAL PRADESH,2011,Total Tempo/Vans,66,6,72
HIMACHAL PRADESH,2011,Total Jeep,115,16,131
HIMACHAL PRADESH,2011,Total Car,236,43,279
HIMACHAL PRADESH,2012,Truck/Lorry (Government),20,0,20
HIMACHAL PRADESH,2012,Truck/Lorry (Private),105,10,115
HIMACHAL PRADESH,2012,Bus (Government),63,12,75
HIMACHAL PRADESH,2012,Bus (Private),78,35,113
HIMACHAL PRADESH,2012,Tempo/Vans (Government),1,1,2
HIMACHAL PRADESH,2012,Tempo/Vans (Private),33,3,36
HIMACHAL PRADESH,2012,Jeep (Government),0,0,0
HIMACHAL PRADESH,2012,Jeep (Private),94,20,114
HIMACHAL PRADESH,2012,Car (Government),0,0,0
HIMACHAL PRADESH,2012,Car (Private),272,39,311
HIMACHAL PRADESH,2012,Three Wheeler,8,0,8
HIMACHAL PRADESH,2012,Two Wheeler,157,21,178
HIMACHAL PRADESH,2012,Bicycle,0,0,0
HIMACHAL PRADESH,2012,Pedestrian,15,2,17
HIMACHAL PRADESH,2012,Others (Please Specify),110,10,120
HIMACHAL PRADESH,2012,Total Deaths (Persons),956,153,1109
HIMACHAL PRADESH,2012,Total Truck/Lorry,125,10,135
HIMACHAL PRADESH,2012,Total Bus,141,47,188
HIMACHAL PRADESH,2012,Total Tempo/Vans,34,4,38
HIMACHAL PRADESH,2012,Total Jeep,94,20,114
HIMACHAL PRADESH,2012,Total Car,272,39,311
JAMMU & KASHMIR,2001,Truck/Lorry (Government),35,1,36
JAMMU & KASHMIR,2001,Truck/Lorry (Private),154,13,167
JAMMU & KASHMIR,2001,Bus (Government),11,8,19
JAMMU & KASHMIR,2001,Bus (Private),197,46,243
JAMMU & KASHMIR,2001,Tempo/Vans (Government),0,1,1
JAMMU & KASHMIR,2001,Tempo/Vans (Private),90,9,99
JAMMU & KASHMIR,2001,Jeep (Government),6,0,6
JAMMU & KASHMIR,2001,Jeep (Private),28,2,30
JAMMU & KASHMIR,2001,Car (Government),3,3,6
JAMMU & KASHMIR,2001,Car (Private),37,13,50
JAMMU & KASHMIR,2001,Three Wheeler,4,2,6
JAMMU & KASHMIR,2001,Two Wheeler,43,6,49
JAMMU & KASHMIR,2001,Bicycle,31,11,42
JAMMU & KASHMIR,2001,Pedestrian,0,0,0
JAMMU & KASHMIR,2001,Others (Please Specify),158,33,191
JAMMU & KASHMIR,2001,Total Deaths (Persons),797,148,945
JAMMU & KASHMIR,2001,Total Truck/Lorry,189,14,203
JAMMU & KASHMIR,2001,Total Bus,208,54,262
JAMMU & KASHMIR,2001,Total Tempo/Vans,90,10,100
JAMMU & KASHMIR,2001,Total Jeep,34,2,36
JAMMU & KASHMIR,2001,Total Car,40,16,56
JAMMU & KASHMIR,2002,Truck/Lorry (Government),28,1,29
JAMMU & KASHMIR,2002,Truck/Lorry (Private),152,21,173
JAMMU & KASHMIR,2002,Bus (Government),15,7,22
JAMMU & KASHMIR,2002,Bus (Private),136,35,171
JAMMU & KASHMIR,2002,Tempo/Vans (Government),12,0,12
JAMMU & KASHMIR,2002,Tempo/Vans (Private),41,17,58
JAMMU & KASHMIR,2002,Jeep (Government),1,1,2
JAMMU & KASHMIR,2002,Jeep (Private),18,4,22
JAMMU & KASHMIR,2002,Car (Government),0,1,1
JAMMU & KASHMIR,2002,Car (Private),77,17,94
JAMMU & KASHMIR,2002,Three Wheeler,7,4,11
JAMMU & KASHMIR,2002,Two Wheeler,49,6,55
JAMMU & KASHMIR,2002,Bicycle,1,0,1
JAMMU & KASHMIR,2002,Pedestrian,28,6,34
JAMMU & KASHMIR,2002,Others (Please Specify),184,19,203
JAMMU & KASHMIR,2002,Total Deaths (Persons),749,139,888
JAMMU & KASHMIR,2002,Total Truck/Lorry,180,22,202
JAMMU & KASHMIR,2002,Total Bus,151,42,193
JAMMU & KASHMIR,2002,Total Tempo/Vans,53,17,70
JAMMU & KASHMIR,2002,Total Jeep,19,5,24
JAMMU & KASHMIR,2002,Total Car,77,18,95
JAMMU & KASHMIR,2003,Truck/Lorry (Government),35,2,37
JAMMU & KASHMIR,2003,Truck/Lorry (Private),152,15,167
JAMMU & KASHMIR,2003,Bus (Government),5,0,5
JAMMU & KASHMIR,2003,Bus (Private),138,43,181
JAMMU & KASHMIR,2003,Tempo/Vans (Government),4,1,5
JAMMU & KASHMIR,2003,Tempo/Vans (Private),49,9,58
JAMMU & KASHMIR,2003,Jeep (Government),0,0,0
JAMMU & KASHMIR,2003,Jeep (Private),11,4,15
JAMMU & KASHMIR,2003,Car (Government),1,0,1
JAMMU & KASHMIR,2003,Car (Private),32,14,46
JAMMU & KASHMIR,2003,Three Wheeler,4,0,4
JAMMU & KASHMIR,2003,Two Wheeler,64,14,78
JAMMU & KASHMIR,2003,Bicycle,2,0,2
JAMMU & KASHMIR,2003,Pedestrian,40,8,48
JAMMU & KASHMIR,2003,Others (Please Specify),177,31,208
JAMMU & KASHMIR,2003,Total Deaths (Persons),714,141,855
JAMMU & KASHMIR,2003,Total Truck/Lorry,187,17,204
JAMMU & KASHMIR,2003,Total Bus,143,43,186
JAMMU & KASHMIR,2003,Total Tempo/Vans,53,10,63
JAMMU & KASHMIR,2003,Total Jeep,11,4,15
JAMMU & KASHMIR,2003,Total Car,33,14,47
JAMMU & KASHMIR,2004,Truck/Lorry (Government),26,3,29
JAMMU & KASHMIR,2004,Truck/Lorry (Private),132,17,149
JAMMU & KASHMIR,2004,Bus (Government),1,0,1
JAMMU & KASHMIR,2004,Bus (Private),201,63,264
JAMMU & KASHMIR,2004,Tempo/Vans (Government),0,0,0
JAMMU & KASHMIR,2004,Tempo/Vans (Private),59,9,68
JAMMU & KASHMIR,2004,Jeep (Government),8,2,10
JAMMU & KASHMIR,2004,Jeep (Private),28,11,39
JAMMU & KASHMIR,2004,Car (Government),3,0,3
JAMMU & KASHMIR,2004,Car (Private),34,13,47
JAMMU & KASHMIR,2004,Three Wheeler,7,4,11
JAMMU & KASHMIR,2004,Two Wheeler,64,13,77
JAMMU & KASHMIR,2004,Bicycle,6,2,8
JAMMU & KASHMIR,2004,Pedestrian,20,4,24
JAMMU & KASHMIR,2004,Others (Please Specify),225,14,239
JAMMU & KASHMIR,2004,Total Deaths (Persons),814,155,969
JAMMU & KASHMIR,2004,Total Truck/Lorry,158,20,178
JAMMU & KASHMIR,2004,Total Bus,202,63,265
JAMMU & KASHMIR,2004,Total Tempo/Vans,59,9,68
JAMMU & KASHMIR,2004,Total Jeep,36,13,49
JAMMU & KASHMIR,2004,Total Car,37,13,50
JAMMU & KASHMIR,2005,Truck/Lorry (Government),47,1,48
JAMMU & KASHMIR,2005,Truck/Lorry (Private),135,14,149
JAMMU & KASHMIR,2005,Bus (Government),9,0,9
JAMMU & KASHMIR,2005,Bus (Private),194,28,222
JAMMU & KASHMIR,2005,Tempo/Vans (Government),0,0,0
JAMMU & KASHMIR,2005,Tempo/Vans (Private),61,9,70
JAMMU & KASHMIR,2005,Jeep (Government),0,0,0
JAMMU & KASHMIR,2005,Jeep (Private),23,4,27
JAMMU & KASHMIR,2005,Car (Government),6,1,7
JAMMU & KASHMIR,2005,Car (Private),48,16,64
JAMMU & KASHMIR,2005,Three Wheeler,14,2,16
JAMMU & KASHMIR,2005,Two Wheeler,61,8,69
JAMMU & KASHMIR,2005,Bicycle,0,0,0
JAMMU & KASHMIR,2005,Pedestrian,11,6,17
JAMMU & KASHMIR,2005,Others (Please Specify),124,35,159
JAMMU & KASHMIR,2005,Total Deaths (Persons),733,124,857
JAMMU & KASHMIR,2005,Total Truck/Lorry,182,15,197
JAMMU & KASHMIR,2005,Total Bus,203,28,231
JAMMU & KASHMIR,2005,Total Tempo/Vans,61,9,70
JAMMU & KASHMIR,2005,Total Jeep,23,4,27
JAMMU & KASHMIR,2005,Total Car,54,17,71
JAMMU & KASHMIR,2006,Truck/Lorry (Government),19,4,23
JAMMU & KASHMIR,2006,Truck/Lorry (Private),144,29,173
JAMMU & KASHMIR,2006,Bus (Government),21,6,27
JAMMU & KASHMIR,2006,Bus (Private),246,69,315
JAMMU & KASHMIR,2006,Tempo/Vans (Government),1,0,1
JAMMU & KASHMIR,2006,Tempo/Vans (Private),72,7,79
JAMMU & KASHMIR,2006,Jeep (Government),4,1,5
JAMMU & KASHMIR,2006,Jeep (Private),4,2,6
JAMMU & KASHMIR,2006,Car (Government),5,2,7
JAMMU & KASHMIR,2006,Car (Private),86,21,107
JAMMU & KASHMIR,2006,Three Wheeler,35,10,45
JAMMU & KASHMIR,2006,Two Wheeler,77,16,93
JAMMU & KASHMIR,2006,Bicycle,12,1,13
JAMMU & KASHMIR,2006,Pedestrian,23,3,26
JAMMU & KASHMIR,2006,Others (Please Specify),130,42,172
JAMMU & KASHMIR,2006,Total Deaths (Persons),879,213,1092
JAMMU & KASHMIR,2006,Total Truck/Lorry,163,33,196
JAMMU & KASHMIR,2006,Total Bus,267,75,342
JAMMU & KASHMIR,2006,Total Tempo/Vans,73,7,80
JAMMU & KASHMIR,2006,Total Jeep,8,3,11
JAMMU & KASHMIR,2006,Total Car,91,23,114
JAMMU & KASHMIR,2007,Truck/Lorry (Government),10,3,13
JAMMU & KASHMIR,2007,Truck/Lorry (Private),133,18,151
JAMMU & KASHMIR,2007,Bus (Government),8,1,9
JAMMU & KASHMIR,2007,Bus (Private),153,49,202
JAMMU & KASHMIR,2007,Tempo/Vans (Government),12,2,14
JAMMU & KASHMIR,2007,Tempo/Vans (Private),78,12,90
JAMMU & KASHMIR,2007,Jeep (Government),2,0,2
JAMMU & KASHMIR,2007,Jeep (Private),14,0,14
JAMMU & KASHMIR,2007,Car (Government),11,0,11
JAMMU & KASHMIR,2007,Car (Private),100,24,124
JAMMU & KASHMIR,2007,Three Wheeler,9,1,10
JAMMU & KASHMIR,2007,Two Wheeler,84,15,99
JAMMU & KASHMIR,2007,Bicycle,1,0,1
JAMMU & KASHMIR,2007,Pedestrian,46,5,51
JAMMU & KASHMIR,2007,Others (Please Specify),135,26,161
JAMMU & KASHMIR,2007,Total Deaths (Persons),796,156,952
JAMMU & KASHMIR,2007,Total Truck/Lorry,143,21,164
JAMMU & KASHMIR,2007,Total Bus,161,50,211
JAMMU & KASHMIR,2007,Total Tempo/Vans,90,14,104
JAMMU & KASHMIR,2007,Total Jeep,16,0,16
JAMMU & KASHMIR,2007,Total Car,111,24,135
JAMMU & KASHMIR,2008,Truck/Lorry (Government),11,0,11
JAMMU & KASHMIR,2008,Truck/Lorry (Private),143,21,164
JAMMU & KASHMIR,2008,Bus (Government),24,5,29
JAMMU & KASHMIR,2008,Bus (Private),106,42,148
JAMMU & KASHMIR,2008,Tempo/Vans (Government),0,0,0
JAMMU & KASHMIR,2008,Tempo/Vans (Private),45,7,52
JAMMU & KASHMIR,2008,Jeep (Government),12,4,16
JAMMU & KASHMIR,2008,Jeep (Private),22,4,26
JAMMU & KASHMIR,2008,Car (Government),6,0,6
JAMMU & KASHMIR,2008,Car (Private),73,22,95
JAMMU & KASHMIR,2008,Three Wheeler,12,1,13
JAMMU & KASHMIR,2008,Two Wheeler,120,25,145
JAMMU & KASHMIR,2008,Bicycle,2,0,2
JAMMU & KASHMIR,2008,Pedestrian,2,3,5
JAMMU & KASHMIR,2008,Others (Please Specify),225,44,269
JAMMU & KASHMIR,2008,Total Deaths (Persons),803,178,981
JAMMU & KASHMIR,2008,Total Truck/Lorry,154,21,175
JAMMU & KASHMIR,2008,Total Bus,130,47,177
JAMMU & KASHMIR,2008,Total Tempo/Vans,45,7,52
JAMMU & KASHMIR,2008,Total Jeep,34,8,42
JAMMU & KASHMIR,2008,Total Car,79,22,101
JAMMU & KASHMIR,2009,Truck/Lorry (Government),4,1,5
JAMMU & KASHMIR,2009,Truck/Lorry (Private),207,17,224
JAMMU & KASHMIR,2009,Bus (Government),12,0,12
JAMMU & KASHMIR,2009,Bus (Private),185,56,241
JAMMU & KASHMIR,2009,Tempo/Vans (Government),0,0,0
JAMMU & KASHMIR,2009,Tempo/Vans (Private),66,17,83
JAMMU & KASHMIR,2009,Jeep (Government),6,1,7
JAMMU & KASHMIR,2009,Jeep (Private),15,11,26
JAMMU & KASHMIR,2009,Car (Government),7,1,8
JAMMU & KASHMIR,2009,Car (Private),100,17,117
JAMMU & KASHMIR,2009,Three Wheeler,23,5,28
JAMMU & KASHMIR,2009,Two Wheeler,118,15,133
JAMMU & KASHMIR,2009,Bicycle,11,5,16
JAMMU & KASHMIR,2009,Pedestrian,47,15,62
JAMMU & KASHMIR,2009,Others (Please Specify),174,35,209
JAMMU & KASHMIR,2009,Total Deaths (Persons),975,196,1171
JAMMU & KASHMIR,2009,Total Truck/Lorry,211,18,229
JAMMU & KASHMIR,2009,Total Bus,197,56,253
JAMMU & KASHMIR,2009,Total Tempo/Vans,66,17,83
JAMMU & KASHMIR,2009,Total Jeep,21,12,33
JAMMU & KASHMIR,2009,Total Car,107,18,125
JAMMU & KASHMIR,2010,Truck/Lorry (Government),7,0,7
JAMMU & KASHMIR,2010,Truck/Lorry (Private),187,17,204
JAMMU & KASHMIR,2010,Bus (Government),4,1,5
JAMMU & KASHMIR,2010,Bus (Private),110,24,134
JAMMU & KASHMIR,2010,Tempo/Vans (Government),2,1,3
JAMMU & KASHMIR,2010,Tempo/Vans (Private),53,23,76
JAMMU & KASHMIR,2010,Jeep (Government),2,0,2
JAMMU & KASHMIR,2010,Jeep (Private),11,3,14
JAMMU & KASHMIR,2010,Car (Government),5,2,7
JAMMU & KASHMIR,2010,Car (Private),109,19,128
JAMMU & KASHMIR,2010,Three Wheeler,14,6,20
JAMMU & KASHMIR,2010,Two Wheeler,121,20,141
JAMMU & KASHMIR,2010,Bicycle,5,1,6
JAMMU & KASHMIR,2010,Pedestrian,28,9,37
JAMMU & KASHMIR,2010,Others (Please Specify),211,34,245
JAMMU & KASHMIR,2010,Total Deaths (Persons),869,160,1029
JAMMU & KASHMIR,2010,Total Truck/Lorry,194,17,211
JAMMU & KASHMIR,2010,Total Bus,114,25,139
JAMMU & KASHMIR,2010,Total Tempo/Vans,55,24,79
JAMMU & KASHMIR,2010,Total Jeep,13,3,16
JAMMU & KASHMIR,2010,Total Car,114,21,135
JAMMU & KASHMIR,2011,Truck/Lorry (Government),4,0,4
JAMMU & KASHMIR,2011,Truck/Lorry (Private),162,13,175
JAMMU & KASHMIR,2011,Bus (Government),2,0,2
JAMMU & KASHMIR,2011,Bus (Private),146,30,176
JAMMU & KASHMIR,2011,Tempo/Vans (Government),4,0,4
JAMMU & KASHMIR,2011,Tempo/Vans (Private),60,14,74
JAMMU & KASHMIR,2011,Jeep (Government),3,0,3
JAMMU & KASHMIR,2011,Jeep (Private),15,0,15
JAMMU & KASHMIR,2011,Car (Government),4,0,4
JAMMU & KASHMIR,2011,Car (Private),84,23,107
JAMMU & KASHMIR,2011,Three Wheeler,13,1,14
JAMMU & KASHMIR,2011,Two Wheeler,122,24,146
JAMMU & KASHMIR,2011,Bicycle,5,0,5
JAMMU & KASHMIR,2011,Pedestrian,63,11,74
JAMMU & KASHMIR,2011,Others (Please Specify),299,38,337
JAMMU & KASHMIR,2011,Total Deaths (Persons),986,154,1140
JAMMU & KASHMIR,2011,Total Truck/Lorry,166,13,179
JAMMU & KASHMIR,2011,Total Bus,148,30,178
JAMMU & KASHMIR,2011,Total Tempo/Vans,64,14,78
JAMMU & KASHMIR,2011,Total Jeep,18,0,18
JAMMU & KASHMIR,2011,Total Car,88,23,111
JAMMU & KASHMIR,2012,Truck/Lorry (Government),8,3,11
JAMMU & KASHMIR,2012,Truck/Lorry (Private),195,22,217
JAMMU & KASHMIR,2012,Bus (Government),21,6,27
JAMMU & KASHMIR,2012,Bus (Private),97,33,130
JAMMU & KASHMIR,2012,Tempo/Vans (Government),6,4,10
JAMMU & KASHMIR,2012,Tempo/Vans (Private),147,24,171
JAMMU & KASHMIR,2012,Jeep (Government),2,2,4
JAMMU & KASHMIR,2012,Jeep (Private),50,10,60
JAMMU & KASHMIR,2012,Car (Government),7,1,8
JAMMU & KASHMIR,2012,Car (Private),143,33,176
JAMMU & KASHMIR,2012,Three Wheeler,8,0,8
JAMMU & KASHMIR,2012,Two Wheeler,143,22,165
JAMMU & KASHMIR,2012,Bicycle,7,4,11
JAMMU & KASHMIR,2012,Pedestrian,47,7,54
JAMMU & KASHMIR,2012,Others (Please Specify),318,56,374
JAMMU & KASHMIR,2012,Total Deaths (Persons),1199,227,1426
JAMMU & KASHMIR,2012,Total Truck/Lorry,203,25,228
JAMMU & KASHMIR,2012,Total Bus,118,39,157
JAMMU & KASHMIR,2012,Total Tempo/Vans,153,28,181
JAMMU & KASHMIR,2012,Total Jeep,52,12,64
JAMMU & KASHMIR,2012,Total Car,150,34,184
JHARKHAND,2001,Truck/Lorry (Government),0,0,0
JHARKHAND,2001,Truck/Lorry (Private),10,0,10
JHARKHAND,2001,Bus (Government),1,0,1
JHARKHAND,2001,Bus (Private),142,27,169
JHARKHAND,2001,Tempo/Vans (Government),0,0,0
JHARKHAND,2001,Tempo/Vans (Private),9,2,11
JHARKHAND,2001,Jeep (Government),0,0,0
JHARKHAND,2001,Jeep (Private),52,9,61
JHARKHAND,2001,Car (Government),3,3,6
JHARKHAND,2001,Car (Private),19,4,23
JHARKHAND,2001,Three Wheeler,9,0,9
JHARKHAND,2001,Two Wheeler,31,2,33
JHARKHAND,2001,Bicycle,1,0,1
JHARKHAND,2001,Pedestrian,31,12,43
JHARKHAND,2001,Others (Please Specify),132,18,150
JHARKHAND,2001,Total Deaths (Persons),440,77,517
JHARKHAND,2001,Total Truck/Lorry,10,0,10
JHARKHAND,2001,Total Bus,143,27,170
JHARKHAND,2001,Total Tempo/Vans,9,2,11
JHARKHAND,2001,Total Jeep,52,9,61
JHARKHAND,2001,Total Car,22,7,29
JHARKHAND,2002,Truck/Lorry (Government),0,0,0
JHARKHAND,2002,Truck/Lorry (Private),12,0,12
JHARKHAND,2002,Bus (Government),2,0,2
JHARKHAND,2002,Bus (Private),140,40,180
JHARKHAND,2002,Tempo/Vans (Government),0,0,0
JHARKHAND,2002,Tempo/Vans (Private),8,20,28
JHARKHAND,2002,Jeep (Government),0,0,0
JHARKHAND,2002,Jeep (Private),56,20,76
JHARKHAND,2002,Car (Government),4,2,6
JHARKHAND,2002,Car (Private),20,6,26
JHARKHAND,2002,Three Wheeler,10,2,12
JHARKHAND,2002,Two Wheeler,35,4,39
JHARKHAND,2002,Bicycle,2,1,3
JHARKHAND,2002,Pedestrian,25,25,50
JHARKHAND,2002,Others (Please Specify),16,4,20
JHARKHAND,2002,Total Deaths (Persons),330,124,454
JHARKHAND,2002,Total Truck/Lorry,12,0,12
JHARKHAND,2002,Total Bus,142,40,182
JHARKHAND,2002,Total Tempo/Vans,8,20,28
JHARKHAND,2002,Total Jeep,56,20,76
JHARKHAND,2002,Total Car,24,8,32
JHARKHAND,2003,Truck/Lorry (Government),0,0,0
JHARKHAND,2003,Truck/Lorry (Private),14,0,14
JHARKHAND,2003,Bus (Government),3,0,3
JHARKHAND,2003,Bus (Private),140,40,180
JHARKHAND,2003,Tempo/Vans (Government),0,0,0
JHARKHAND,2003,Tempo/Vans (Private),7,20,27
JHARKHAND,2003,Jeep (Government),0,0,0
JHARKHAND,2003,Jeep (Private),51,20,71
JHARKHAND,2003,Car (Government),5,2,7
JHARKHAND,2003,Car (Private),21,6,27
JHARKHAND,2003,Three Wheeler,11,2,13
JHARKHAND,2003,Two Wheeler,36,4,40
JHARKHAND,2003,Bicycle,3,1,4
JHARKHAND,2003,Pedestrian,22,25,47
JHARKHAND,2003,Others (Please Specify),17,4,21
JHARKHAND,2003,Total Deaths (Persons),330,124,454
JHARKHAND,2003,Total Truck/Lorry,14,0,14
JHARKHAND,2003,Total Bus,143,40,183
JHARKHAND,2003,Total Tempo/Vans,7,20,27
JHARKHAND,2003,Total Jeep,51,20,71
JHARKHAND,2003,Total Car,26,8,34
JHARKHAND,2004,Truck/Lorry (Government),0,0,0
JHARKHAND,2004,Truck/Lorry (Private),15,13,28
JHARKHAND,2004,Bus (Government),0,0,0
JHARKHAND,2004,Bus (Private),176,26,202
JHARKHAND,2004,Tempo/Vans (Government),0,0,0
JHARKHAND,2004,Tempo/Vans (Private),31,14,45
JHARKHAND,2004,Jeep (Government),0,0,0
JHARKHAND,2004,Jeep (Private),75,13,88
JHARKHAND,2004,Car (Government),7,2,9
JHARKHAND,2004,Car (Private),28,9,37
JHARKHAND,2004,Three Wheeler,15,4,19
JHARKHAND,2004,Two Wheeler,47,26,73
JHARKHAND,2004,Bicycle,6,4,10
JHARKHAND,2004,Pedestrian,51,27,78
JHARKHAND,2004,Others (Please Specify),21,4,25
JHARKHAND,2004,Total Deaths (Persons),472,142,614
JHARKHAND,2004,Total Truck/Lorry,15,13,28
JHARKHAND,2004,Total Bus,176,26,202
JHARKHAND,2004,Total Tempo/Vans,31,14,45
JHARKHAND,2004,Total Jeep,75,13,88
JHARKHAND,2004,Total Car,35,11,46
JHARKHAND,2005,Truck/Lorry (Government),0,0,0
JHARKHAND,2005,Truck/Lorry (Private),421,46,467
JHARKHAND,2005,Bus (Government),0,0,0
JHARKHAND,2005,Bus (Private),133,25,158
JHARKHAND,2005,Tempo/Vans (Government),0,0,0
JHARKHAND,2005,Tempo/Vans (Private),48,14,62
JHARKHAND,2005,Jeep (Government),0,0,0
JHARKHAND,2005,Jeep (Private),117,12,129
JHARKHAND,2005,Car (Government),0,0,0
JHARKHAND,2005,Car (Private),67,13,80
JHARKHAND,2005,Three Wheeler,36,14,50
JHARKHAND,2005,Two Wheeler,103,18,121
JHARKHAND,2005,Bicycle,36,0,36
JHARKHAND,2005,Pedestrian,74,15,89
JHARKHAND,2005,Others (Please Specify),72,18,90
JHARKHAND,2005,Total Deaths (Persons),1107,175,1282
JHARKHAND,2005,Total Truck/Lorry,421,46,467
JHARKHAND,2005,Total Bus,133,25,158
JHARKHAND,2005,Total Tempo/Vans,48,14,62
JHARKHAND,2005,Total Jeep,117,12,129
JHARKHAND,2005,Total Car,67,13,80
JHARKHAND,2006,Truck/Lorry (Government),3,0,3
JHARKHAND,2006,Truck/Lorry (Private),328,34,362
JHARKHAND,2006,Bus (Government),1,0,1
JHARKHAND,2006,Bus (Private),180,51,231
JHARKHAND,2006,Tempo/Vans (Government),0,0,0
JHARKHAND,2006,Tempo/Vans (Private),90,18,108
JHARKHAND,2006,Jeep (Government),13,5,18
JHARKHAND,2006,Jeep (Private),132,28,160
JHARKHAND,2006,Car (Government),5,0,5
JHARKHAND,2006,Car (Private),70,8,78
JHARKHAND,2006,Three Wheeler,44,4,48
JHARKHAND,2006,Two Wheeler,369,37,406
JHARKHAND,2006,Bicycle,36,4,40
JHARKHAND,2006,Pedestrian,95,26,121
JHARKHAND,2006,Others (Please Specify),52,34,86
JHARKHAND,2006,Total Deaths (Persons),1418,249,1667
JHARKHAND,2006,Total Truck/Lorry,331,34,365
JHARKHAND,2006,Total Bus,181,51,232
JHARKHAND,2006,Total Tempo/Vans,90,18,108
JHARKHAND,2006,Total Jeep,145,33,178
JHARKHAND,2006,Total Car,75,8,83
JHARKHAND,2007,Truck/Lorry (Government),16,3,19
JHARKHAND,2007,Truck/Lorry (Private),308,47,355
JHARKHAND,2007,Bus (Government),6,1,7
JHARKHAND,2007,Bus (Private),211,25,236
JHARKHAND,2007,Tempo/Vans (Government),3,0,3
JHARKHAND,2007,Tempo/Vans (Private),112,15,127
JHARKHAND,2007,Jeep (Government),8,1,9
JHARKHAND,2007,Jeep (Private),205,32,237
JHARKHAND,2007,Car (Government),0,0,0
JHARKHAND,2007,Car (Private),97,20,117
JHARKHAND,2007,Three Wheeler,85,10,95
JHARKHAND,2007,Two Wheeler,232,30,262
JHARKHAND,2007,Bicycle,40,0,40
JHARKHAND,2007,Pedestrian,94,18,112
JHARKHAND,2007,Others (Please Specify),130,11,141
JHARKHAND,2007,Total Deaths (Persons),1547,213,1760
JHARKHAND,2007,Total Truck/Lorry,324,50,374
JHARKHAND,2007,Total Bus,217,26,243
JHARKHAND,2007,Total Tempo/Vans,115,15,130
JHARKHAND,2007,Total Jeep,213,33,246
JHARKHAND,2007,Total Car,97,20,117
JHARKHAND,2008,Truck/Lorry (Government),24,1,25
JHARKHAND,2008,Truck/Lorry (Private),416,45,461
JHARKHAND,2008,Bus (Government),6,0,6
JHARKHAND,2008,Bus (Private),140,25,165
JHARKHAND,2008,Tempo/Vans (Government),8,2,10
JHARKHAND,2008,Tempo/Vans (Private),95,11,106
JHARKHAND,2008,Jeep (Government),14,0,14
JHARKHAND,2008,Jeep (Private),143,24,167
JHARKHAND,2008,Car (Government),12,0,12
JHARKHAND,2008,Car (Private),93,6,99
JHARKHAND,2008,Three Wheeler,57,5,62
JHARKHAND,2008,Two Wheeler,215,22,237
JHARKHAND,2008,Bicycle,55,0,55
JHARKHAND,2008,Pedestrian,89,10,99
JHARKHAND,2008,Others (Please Specify),49,7,56
JHARKHAND,2008,Total Deaths (Persons),1416,158,1574
JHARKHAND,2008,Total Truck/Lorry,440,46,486
JHARKHAND,2008,Total Bus,146,25,171
JHARKHAND,2008,Total Tempo/Vans,103,13,116
JHARKHAND,2008,Total Jeep,157,24,181
JHARKHAND,2008,Total Car,105,6,111
JHARKHAND,2009,Truck/Lorry (Government),89,2,91
JHARKHAND,2009,Truck/Lorry (Private),426,52,478
JHARKHAND,2009,Bus (Government),5,2,7
JHARKHAND,2009,Bus (Private),145,38,183
JHARKHAND,2009,Tempo/Vans (Government),8,0,8
JHARKHAND,2009,Tempo/Vans (Private),99,18,117
JHARKHAND,2009,Jeep (Government),16,1,17
JHARKHAND,2009,Jeep (Private),118,16,134
JHARKHAND,2009,Car (Government),3,0,3
JHARKHAND,2009,Car (Private),102,28,130
JHARKHAND,2009,Three Wheeler,44,7,51
JHARKHAND,2009,Two Wheeler,479,67,546
JHARKHAND,2009,Bicycle,31,0,31
JHARKHAND,2009,Pedestrian,92,8,100
JHARKHAND,2009,Others (Please Specify),98,32,130
JHARKHAND,2009,Total Deaths (Persons),1755,271,2026
JHARKHAND,2009,Total Truck/Lorry,515,54,569
JHARKHAND,2009,Total Bus,150,40,190
JHARKHAND,2009,Total Tempo/Vans,107,18,125
JHARKHAND,2009,Total Jeep,134,17,151
JHARKHAND,2009,Total Car,105,28,133
JHARKHAND,2010,Truck/Lorry (Government),39,18,57
JHARKHAND,2010,Truck/Lorry (Private),348,67,415
JHARKHAND,2010,Bus (Government),24,1,25
JHARKHAND,2010,Bus (Private),214,59,273
JHARKHAND,2010,Tempo/Vans (Government),36,4,40
JHARKHAND,2010,Tempo/Vans (Private),85,36,121
JHARKHAND,2010,Jeep (Government),10,2,12
JHARKHAND,2010,Jeep (Private),136,30,166
JHARKHAND,2010,Car (Government),4,0,4
JHARKHAND,2010,Car (Private),80,20,100
JHARKHAND,2010,Three Wheeler,77,18,95
JHARKHAND,2010,Two Wheeler,315,81,396
JHARKHAND,2010,Bicycle,113,22,135
JHARKHAND,2010,Pedestrian,87,39,126
JHARKHAND,2010,Others (Please Specify),149,26,175
JHARKHAND,2010,Total Deaths (Persons),1717,423,2140
JHARKHAND,2010,Total Truck/Lorry,387,85,472
JHARKHAND,2010,Total Bus,238,60,298
JHARKHAND,2010,Total Tempo/Vans,121,40,161
JHARKHAND,2010,Total Jeep,146,32,178
JHARKHAND,2010,Total Car,84,20,104
JHARKHAND,2011,Truck/Lorry (Government),17,0,17
JHARKHAND,2011,Truck/Lorry (Private),313,37,350
JHARKHAND,2011,Bus (Government),0,0,0
JHARKHAND,2011,Bus (Private),167,44,211
JHARKHAND,2011,Tempo/Vans (Government),4,0,4
JHARKHAND,2011,Tempo/Vans (Private),72,16,88
JHARKHAND,2011,Jeep (Government),11,1,12
JHARKHAND,2011,Jeep (Private),111,8,119
JHARKHAND,2011,Car (Government),17,2,19
JHARKHAND,2011,Car (Private),131,21,152
JHARKHAND,2011,Three Wheeler,108,22,130
JHARKHAND,2011,Two Wheeler,378,41,419
JHARKHAND,2011,Bicycle,106,5,111
JHARKHAND,2011,Pedestrian,176,52,228
JHARKHAND,2011,Others (Please Specify),75,118,193
JHARKHAND,2011,Total Deaths (Persons),1686,367,2053
JHARKHAND,2011,Total Truck/Lorry,330,37,367
JHARKHAND,2011,Total Bus,167,44,211
JHARKHAND,2011,Total Tempo/Vans,76,16,92
JHARKHAND,2011,Total Jeep,122,9,131
JHARKHAND,2011,Total Car,148,23,171
JHARKHAND,2012,Truck/Lorry (Government),0,1,1
JHARKHAND,2012,Truck/Lorry (Private),568,61,629
JHARKHAND,2012,Bus (Government),0,0,0
JHARKHAND,2012,Bus (Private),255,58,313
JHARKHAND,2012,Tempo/Vans (Government),1,0,1
JHARKHAND,2012,Tempo/Vans (Private),96,25,121
JHARKHAND,2012,Jeep (Government),2,0,2
JHARKHAND,2012,Jeep (Private),122,34,156
JHARKHAND,2012,Car (Government),36,5,41
JHARKHAND,2012,Car (Private),121,20,141
JHARKHAND,2012,Three Wheeler,95,18,113
JHARKHAND,2012,Two Wheeler,490,67,557
JHARKHAND,2012,Bicycle,51,8,59
JHARKHAND,2012,Pedestrian,97,30,127
JHARKHAND,2012,Others (Please Specify),216,35,251
JHARKHAND,2012,Total Deaths (Persons),2150,362,2512
JHARKHAND,2012,Total Truck/Lorry,568,62,630
JHARKHAND,2012,Total Bus,255,58,313
JHARKHAND,2012,Total Tempo/Vans,97,25,122
JHARKHAND,2012,Total Jeep,124,34,158
JHARKHAND,2012,Total Car,157,25,182
KARNATAKA,2001,Truck/Lorry (Government),20,9,29
KARNATAKA,2001,Truck/Lorry (Private),1414,186,1600
KARNATAKA,2001,Bus (Government),287,79,366
KARNATAKA,2001,Bus (Private),357,91,448
KARNATAKA,2001,Tempo/Vans (Government),3,0,3
KARNATAKA,2001,Tempo/Vans (Private),580,119,699
KARNATAKA,2001,Jeep (Government),5,0,5
KARNATAKA,2001,Jeep (Private),230,33,263
KARNATAKA,2001,Car (Government),14,0,14
KARNATAKA,2001,Car (Private),259,53,312
KARNATAKA,2001,Three Wheeler,127,25,152
KARNATAKA,2001,Two Wheeler,841,65,906
KARNATAKA,2001,Bicycle,63,5,68
KARNATAKA,2001,Pedestrian,324,70,394
KARNATAKA,2001,Others (Please Specify),447,89,536
KARNATAKA,2001,Total Deaths (Persons),4971,824,5795
KARNATAKA,2001,Total Truck/Lorry,1434,195,1629
KARNATAKA,2001,Total Bus,644,170,814
KARNATAKA,2001,Total Tempo/Vans,583,119,702
KARNATAKA,2001,Total Jeep,235,33,268
KARNATAKA,2001,Total Car,273,53,326
KARNATAKA,2002,Truck/Lorry (Government),25,9,34
KARNATAKA,2002,Truck/Lorry (Private),1294,174,1468
KARNATAKA,2002,Bus (Government),318,61,379
KARNATAKA,2002,Bus (Private),293,68,361
KARNATAKA,2002,Tempo/Vans (Government),26,4,30
KARNATAKA,2002,Tempo/Vans (Private),524,91,615
KARNATAKA,2002,Jeep (Government),4,1,5
KARNATAKA,2002,Jeep (Private),196,43,239
KARNATAKA,2002,Car (Government),8,1,9
KARNATAKA,2002,Car (Private),294,78,372
KARNATAKA,2002,Three Wheeler,214,24,238
KARNATAKA,2002,Two Wheeler,966,115,1081
KARNATAKA,2002,Bicycle,114,24,138
KARNATAKA,2002,Pedestrian,455,97,552
KARNATAKA,2002,Others (Please Specify),512,318,830
KARNATAKA,2002,Total Deaths (Persons),5243,1108,6351
KARNATAKA,2002,Total Truck/Lorry,1319,183,1502
KARNATAKA,2002,Total Bus,611,129,740
KARNATAKA,2002,Total Tempo/Vans,550,95,645
KARNATAKA,2002,Total Jeep,200,44,244
KARNATAKA,2002,Total Car,302,79,381
KARNATAKA,2003,Truck/Lorry (Government),18,1,19
KARNATAKA,2003,Truck/Lorry (Private),1237,167,1404
KARNATAKA,2003,Bus (Government),279,54,333
KARNATAKA,2003,Bus (Private),334,65,399
KARNATAKA,2003,Tempo/Vans (Government),5,2,7
KARNATAKA,2003,Tempo/Vans (Private),589,111,700
KARNATAKA,2003,Jeep (Government),11,6,17
KARNATAKA,2003,Jeep (Private),260,53,313
KARNATAKA,2003,Car (Government),2,1,3
KARNATAKA,2003,Car (Private),308,72,380
KARNATAKA,2003,Three Wheeler,209,46,255
KARNATAKA,2003,Two Wheeler,980,95,1075
KARNATAKA,2003,Bicycle,96,4,100
KARNATAKA,2003,Pedestrian,454,104,558
KARNATAKA,2003,Others (Please Specify),500,109,609
KARNATAKA,2003,Total Deaths (Persons),5282,890,6172
KARNATAKA,2003,Total Truck/Lorry,1255,168,1423
KARNATAKA,2003,Total Bus,613,119,732
KARNATAKA,2003,Total Tempo/Vans,594,113,707
KARNATAKA,2003,Total Jeep,271,59,330
KARNATAKA,2003,Total Car,310,73,383
KARNATAKA,2004,Truck/Lorry (Government),6,2,8
KARNATAKA,2004,Truck/Lorry (Private),1197,172,1369
KARNATAKA,2004,Bus (Government),278,85,363
KARNATAKA,2004,Bus (Private),261,73,334
KARNATAKA,2004,Tempo/Vans (Government),9,0,9
KARNATAKA,2004,Tempo/Vans (Private),451,111,562
KARNATAKA,2004,Jeep (Government),9,2,11
KARNATAKA,2004,Jeep (Private),222,55,277
KARNATAKA,2004,Car (Government),4,1,5
KARNATAKA,2004,Car (Private),331,66,397
KARNATAKA,2004,Three Wheeler,204,69,273
KARNATAKA,2004,Two Wheeler,1056,148,1204
KARNATAKA,2004,Bicycle,132,15,147
KARNATAKA,2004,Pedestrian,591,154,745
KARNATAKA,2004,Others (Please Specify),675,102,777
KARNATAKA,2004,Total Deaths (Persons),5426,1055,6481
KARNATAKA,2004,Total Truck/Lorry,1203,174,1377
KARNATAKA,2004,Total Bus,539,158,697
KARNATAKA,2004,Total Tempo/Vans,460,111,571
KARNATAKA,2004,Total Jeep,231,57,288
KARNATAKA,2004,Total Car,335,67,402
KARNATAKA,2005,Truck/Lorry (Government),15,2,17
KARNATAKA,2005,Truck/Lorry (Private),1127,109,1236
KARNATAKA,2005,Bus (Government),269,53,322
KARNATAKA,2005,Bus (Private),285,71,356
KARNATAKA,2005,Tempo/Vans (Government),17,0,17
KARNATAKA,2005,Tempo/Vans (Private),456,109,565
KARNATAKA,2005,Jeep (Government),5,1,6
KARNATAKA,2005,Jeep (Private),245,47,292
KARNATAKA,2005,Car (Government),10,3,13
KARNATAKA,2005,Car (Private),340,74,414
KARNATAKA,2005,Three Wheeler,215,47,262
KARNATAKA,2005,Two Wheeler,1475,120,1595
KARNATAKA,2005,Bicycle,144,7,151
KARNATAKA,2005,Pedestrian,795,215,1010
KARNATAKA,2005,Others (Please Specify),537,83,620
KARNATAKA,2005,Total Deaths (Persons),5935,941,6876
KARNATAKA,2005,Total Truck/Lorry,1142,111,1253
KARNATAKA,2005,Total Bus,554,124,678
KARNATAKA,2005,Total Tempo/Vans,473,109,582
KARNATAKA,2005,Total Jeep,250,48,298
KARNATAKA,2005,Total Car,350,77,427
KARNATAKA,2006,Truck/Lorry (Government),43,6,49
KARNATAKA,2006,Truck/Lorry (Private),1315,150,1465
KARNATAKA,2006,Bus (Government),287,62,349
KARNATAKA,2006,Bus (Private),437,75,512
KARNATAKA,2006,Tempo/Vans (Government),3,0,3
KARNATAKA,2006,Tempo/Vans (Private),486,103,589
KARNATAKA,2006,Jeep (Government),9,0,9
KARNATAKA,2006,Jeep (Private),270,49,319
KARNATAKA,2006,Car (Government),12,2,14
KARNATAKA,2006,Car (Private),380,91,471
KARNATAKA,2006,Three Wheeler,346,93,439
KARNATAKA,2006,Two Wheeler,1467,150,1617
KARNATAKA,2006,Bicycle,137,13,150
KARNATAKA,2006,Pedestrian,694,115,809
KARNATAKA,2006,Others (Please Specify),1004,140,1144
KARNATAKA,2006,Total Deaths (Persons),6890,1049,7939
KARNATAKA,2006,Total Truck/Lorry,1358,156,1514
KARNATAKA,2006,Total Bus,724,137,861
KARNATAKA,2006,Total Tempo/Vans,489,103,592
KARNATAKA,2006,Total Jeep,279,49,328
KARNATAKA,2006,Total Car,392,93,485
KARNATAKA,2007,Truck/Lorry (Government),18,0,18
KARNATAKA,2007,Truck/Lorry (Private),1543,132,1675
KARNATAKA,2007,Bus (Government),299,63,362
KARNATAKA,2007,Bus (Private),526,81,607
KARNATAKA,2007,Tempo/Vans (Government),11,3,14
KARNATAKA,2007,Tempo/Vans (Private),595,132,727
KARNATAKA,2007,Jeep (Government),10,0,10
KARNATAKA,2007,Jeep (Private),312,46,358
KARNATAKA,2007,Car (Government),11,0,11
KARNATAKA,2007,Car (Private),413,97,510
KARNATAKA,2007,Three Wheeler,401,90,491
KARNATAKA,2007,Two Wheeler,1750,181,1931
KARNATAKA,2007,Bicycle,85,8,93
KARNATAKA,2007,Pedestrian,618,74,692
KARNATAKA,2007,Others (Please Specify),1075,188,1263
KARNATAKA,2007,Total Deaths (Persons),7667,1095,8762
KARNATAKA,2007,Total Truck/Lorry,1561,132,1693
KARNATAKA,2007,Total Bus,825,144,969
KARNATAKA,2007,Total Tempo/Vans,606,135,741
KARNATAKA,2007,Total Jeep,322,46,368
KARNATAKA,2007,Total Car,424,97,521
KARNATAKA,2008,Truck/Lorry (Government),17,1,18
KARNATAKA,2008,Truck/Lorry (Private),1582,132,1714
KARNATAKA,2008,Bus (Government),406,74,480
KARNATAKA,2008,Bus (Private),464,81,545
KARNATAKA,2008,Tempo/Vans (Government),5,0,5
KARNATAKA,2008,Tempo/Vans (Private),521,100,621
KARNATAKA,2008,Jeep (Government),5,0,5
KARNATAKA,2008,Jeep (Private),327,64,391
KARNATAKA,2008,Car (Government),12,4,16
KARNATAKA,2008,Car (Private),453,103,556
KARNATAKA,2008,Three Wheeler,416,127,543
KARNATAKA,2008,Two Wheeler,1725,200,1925
KARNATAKA,2008,Bicycle,84,9,93
KARNATAKA,2008,Pedestrian,538,53,591
KARNATAKA,2008,Others (Please Specify),1180,131,1311
KARNATAKA,2008,Total Deaths (Persons),7735,1079,8814
KARNATAKA,2008,Total Truck/Lorry,1599,133,1732
KARNATAKA,2008,Total Bus,870,155,1025
KARNATAKA,2008,Total Tempo/Vans,526,100,626
KARNATAKA,2008,Total Jeep,332,64,396
KARNATAKA,2008,Total Car,465,107,572
KARNATAKA,2009,Truck/Lorry (Government),13,0,13
KARNATAKA,2009,Truck/Lorry (Private),1767,117,1884
KARNATAKA,2009,Bus (Government),379,78,457
KARNATAKA,2009,Bus (Private),505,88,593
KARNATAKA,2009,Tempo/Vans (Government),4,2,6
KARNATAKA,2009,Tempo/Vans (Private),459,74,533
KARNATAKA,2009,Jeep (Government),21,0,21
KARNATAKA,2009,Jeep (Private),261,73,334
KARNATAKA,2009,Car (Government),4,0,4
KARNATAKA,2009,Car (Private),714,125,839
KARNATAKA,2009,Three Wheeler,407,105,512
KARNATAKA,2009,Two Wheeler,1592,192,1784
KARNATAKA,2009,Bicycle,56,0,56
KARNATAKA,2009,Pedestrian,425,78,503
KARNATAKA,2009,Others (Please Specify),940,235,1175
KARNATAKA,2009,Total Deaths (Persons),7547,1167,8714
KARNATAKA,2009,Total Truck/Lorry,1780,117,1897
KARNATAKA,2009,Total Bus,884,166,1050
KARNATAKA,2009,Total Tempo/Vans,463,76,539
KARNATAKA,2009,Total Jeep,282,73,355
KARNATAKA,2009,Total Car,718,125,843
KARNATAKA,2010,Truck/Lorry (Government),22,2,24
KARNATAKA,2010,Truck/Lorry (Private),1445,126,1571
KARNATAKA,2010,Bus (Government),313,74,387
KARNATAKA,2010,Bus (Private),368,80,448
KARNATAKA,2010,Tempo/Vans (Government),20,4,24
KARNATAKA,2010,Tempo/Vans (Private),386,95,481
KARNATAKA,2010,Jeep (Government),33,9,42
KARNATAKA,2010,Jeep (Private),267,85,352
KARNATAKA,2010,Car (Government),6,1,7
KARNATAKA,2010,Car (Private),497,115,612
KARNATAKA,2010,Three Wheeler,374,98,472
KARNATAKA,2010,Two Wheeler,2014,233,2247
KARNATAKA,2010,Bicycle,63,2,65
KARNATAKA,2010,Pedestrian,742,203,945
KARNATAKA,2010,Others (Please Specify),1675,222,1897
KARNATAKA,2010,Total Deaths (Persons),8225,1349,9574
KARNATAKA,2010,Total Truck/Lorry,1467,128,1595
KARNATAKA,2010,Total Bus,681,154,835
KARNATAKA,2010,Total Tempo/Vans,406,99,505
KARNATAKA,2010,Total Jeep,300,94,394
KARNATAKA,2010,Total Car,503,116,619
KARNATAKA,2011,Truck/Lorry (Government),11,0,11
KARNATAKA,2011,Truck/Lorry (Private),1278,124,1402
KARNATAKA,2011,Bus (Government),301,62,363
KARNATAKA,2011,Bus (Private),335,69,404
KARNATAKA,2011,Tempo/Vans (Government),17,2,19
KARNATAKA,2011,Tempo/Vans (Private),374,88,462
KARNATAKA,2011,Jeep (Government),12,2,14
KARNATAKA,2011,Jeep (Private),270,47,317
KARNATAKA,2011,Car (Government),8,5,13
KARNATAKA,2011,Car (Private),586,103,689
KARNATAKA,2011,Three Wheeler,324,85,409
KARNATAKA,2011,Two Wheeler,2119,213,2332
KARNATAKA,2011,Bicycle,68,2,70
KARNATAKA,2011,Pedestrian,666,171,837
KARNATAKA,2011,Others (Please Specify),1387,229,1616
KARNATAKA,2011,Total Deaths (Persons),7756,1202,8958
KARNATAKA,2011,Total Truck/Lorry,1289,124,1413
KARNATAKA,2011,Total Bus,636,131,767
KARNATAKA,2011,Total Tempo/Vans,391,90,481
KARNATAKA,2011,Total Jeep,282,49,331
KARNATAKA,2011,Total Car,594,108,702
KARNATAKA,2012,Truck/Lorry (Government),15,2,17
KARNATAKA,2012,Truck/Lorry (Private),1260,125,1385
KARNATAKA,2012,Bus (Government),343,86,429
KARNATAKA,2012,Bus (Private),473,82,555
KARNATAKA,2012,Tempo/Vans (Government),11,9,20
KARNATAKA,2012,Tempo/Vans (Private),502,109,611
KARNATAKA,2012,Jeep (Government),12,5,17
KARNATAKA,2012,Jeep (Private),276,65,341
KARNATAKA,2012,Car (Government),12,1,13
KARNATAKA,2012,Car (Private),727,133,860
KARNATAKA,2012,Three Wheeler,351,120,471
KARNATAKA,2012,Two Wheeler,2225,336,2561
KARNATAKA,2012,Bicycle,68,2,70
KARNATAKA,2012,Pedestrian,391,119,510
KARNATAKA,2012,Others (Please Specify),1401,187,1588
KARNATAKA,2012,Total Deaths (Persons),8067,1381,9448
KARNATAKA,2012,Total Truck/Lorry,1275,127,1402
KARNATAKA,2012,Total Bus,816,168,984
KARNATAKA,2012,Total Tempo/Vans,513,118,631
KARNATAKA,2012,Total Jeep,288,70,358
KARNATAKA,2012,Total Car,739,134,873
KERALA,2001,Truck/Lorry (Government),2,0,2
KERALA,2001,Truck/Lorry (Private),159,15,174
KERALA,2001,Bus (Government),99,12,111
KERALA,2001,Bus (Private),280,85,365
KERALA,2001,Tempo/Vans (Government),2,0,2
KERALA,2001,Tempo/Vans (Private),73,9,82
KERALA,2001,Jeep (Government),9,2,11
KERALA,2001,Jeep (Private),170,41,211
KERALA,2001,Car (Government),14,3,17
KERALA,2001,Car (Private),170,38,208
KERALA,2001,Three Wheeler,154,40,194
KERALA,2001,Two Wheeler,530,66,596
KERALA,2001,Bicycle,68,0,68
KERALA,2001,Pedestrian,479,128,607
KERALA,2001,Others (Please Specify),50,9,59
KERALA,2001,Total Deaths (Persons),2259,448,2707
KERALA,2001,Total Truck/Lorry,161,15,176
KERALA,2001,Total Bus,379,97,476
KERALA,2001,Total Tempo/Vans,75,9,84
KERALA,2001,Total Jeep,179,43,222
KERALA,2001,Total Car,184,41,225
KERALA,2002,Truck/Lorry (Government),5,0,5
KERALA,2002,Truck/Lorry (Private),202,21,223
KERALA,2002,Bus (Government),71,12,83
KERALA,2002,Bus (Private),164,44,208
KERALA,2002,Tempo/Vans (Government),2,0,2
KERALA,2002,Tempo/Vans (Private),82,8,90
KERALA,2002,Jeep (Government),8,0,8
KERALA,2002,Jeep (Private),137,32,169
KERALA,2002,Car (Government),4,1,5
KERALA,2002,Car (Private),184,46,230
KERALA,2002,Three Wheeler,230,39,269
KERALA,2002,Two Wheeler,707,52,759
KERALA,2002,Bicycle,95,3,98
KERALA,2002,Pedestrian,528,126,654
KERALA,2002,Others (Please Specify),57,13,70
KERALA,2002,Total Deaths (Persons),2476,397,2873
KERALA,2002,Total Truck/Lorry,207,21,228
KERALA,2002,Total Bus,235,56,291
KERALA,2002,Total Tempo/Vans,84,8,92
KERALA,2002,Total Jeep,145,32,177
KERALA,2002,Total Car,188,47,235
KERALA,2003,Truck/Lorry (Government),8,0,8
KERALA,2003,Truck/Lorry (Private),177,9,186
KERALA,2003,Bus (Government),99,17,116
KERALA,2003,Bus (Private),192,35,227
KERALA,2003,Tempo/Vans (Government),3,0,3
KERALA,2003,Tempo/Vans (Private),109,17,126
KERALA,2003,Jeep (Government),7,1,8
KERALA,2003,Jeep (Private),144,43,187
KERALA,2003,Car (Government),2,0,2
KERALA,2003,Car (Private),172,43,215
KERALA,2003,Three Wheeler,153,50,203
KERALA,2003,Two Wheeler,692,71,763
KERALA,2003,Bicycle,79,6,85
KERALA,2003,Pedestrian,562,166,728
KERALA,2003,Others (Please Specify),67,10,77
KERALA,2003,Total Deaths (Persons),2466,468,2934
KERALA,2003,Total Truck/Lorry,185,9,194
KERALA,2003,Total Bus,291,52,343
KERALA,2003,Total Tempo/Vans,112,17,129
KERALA,2003,Total Jeep,151,44,195
KERALA,2003,Total Car,174,43,217
KERALA,2004,Truck/Lorry (Government),0,3,3
KERALA,2004,Truck/Lorry (Private),257,34,291
KERALA,2004,Bus (Government),72,20,92
KERALA,2004,Bus (Private),151,45,196
KERALA,2004,Tempo/Vans (Government),3,1,4
KERALA,2004,Tempo/Vans (Private),79,14,93
KERALA,2004,Jeep (Government),8,0,8
KERALA,2004,Jeep (Private),112,32,144
KERALA,2004,Car (Government),4,1,5
KERALA,2004,Car (Private),199,43,242
KERALA,2004,Three Wheeler,181,35,216
KERALA,2004,Two Wheeler,757,57,814
KERALA,2004,Bicycle,112,7,119
KERALA,2004,Pedestrian,703,177,880
KERALA,2004,Others (Please Specify),40,7,47
KERALA,2004,Total Deaths (Persons),2678,476,3154
KERALA,2004,Total Truck/Lorry,257,37,294
KERALA,2004,Total Bus,223,65,288
KERALA,2004,Total Tempo/Vans,82,15,97
KERALA,2004,Total Jeep,120,32,152
KERALA,2004,Total Car,203,44,247
KERALA,2005,Truck/Lorry (Government),1,0,1
KERALA,2005,Truck/Lorry (Private),38,6,44
KERALA,2005,Bus (Government),93,9,102
KERALA,2005,Bus (Private),307,49,356
KERALA,2005,Tempo/Vans (Government),2,0,2
KERALA,2005,Tempo/Vans (Private),93,7,100
KERALA,2005,Jeep (Government),6,3,9
KERALA,2005,Jeep (Private),111,18,129
KERALA,2005,Car (Government),3,2,5
KERALA,2005,Car (Private),262,63,325
KERALA,2005,Three Wheeler,245,48,293
KERALA,2005,Two Wheeler,758,97,855
KERALA,2005,Bicycle,43,3,46
KERALA,2005,Pedestrian,632,178,810
KERALA,2005,Others (Please Specify),79,5,84
KERALA,2005,Total Deaths (Persons),2673,488,3161
KERALA,2005,Total Truck/Lorry,39,6,45
KERALA,2005,Total Bus,400,58,458
KERALA,2005,Total Tempo/Vans,95,7,102
KERALA,2005,Total Jeep,117,21,138
KERALA,2005,Total Car,265,65,330
KERALA,2006,Truck/Lorry (Government),0,0,0
KERALA,2006,Truck/Lorry (Private),226,5,231
KERALA,2006,Bus (Government),35,6,41
KERALA,2006,Bus (Private),292,49,341
KERALA,2006,Tempo/Vans (Government),0,0,0
KERALA,2006,Tempo/Vans (Private),183,17,200
KERALA,2006,Jeep (Government),1,0,1
KERALA,2006,Jeep (Private),123,17,140
KERALA,2006,Car (Government),3,0,3
KERALA,2006,Car (Private),262,45,307
KERALA,2006,Three Wheeler,241,48,289
KERALA,2006,Two Wheeler,936,97,1033
KERALA,2006,Bicycle,100,2,102
KERALA,2006,Pedestrian,733,150,883
KERALA,2006,Others (Please Specify),46,10,56
KERALA,2006,Total Deaths (Persons),3181,446,3627
KERALA,2006,Total Truck/Lorry,226,5,231
KERALA,2006,Total Bus,327,55,382
KERALA,2006,Total Tempo/Vans,183,17,200
KERALA,2006,Total Jeep,124,17,141
KERALA,2006,Total Car,265,45,310
KERALA,2007,Truck/Lorry (Government),0,0,0
KERALA,2007,Truck/Lorry (Private),125,8,133
KERALA,2007,Bus (Government),57,21,78
KERALA,2007,Bus (Private),196,50,246
KERALA,2007,Tempo/Vans (Government),11,1,12
KERALA,2007,Tempo/Vans (Private),96,15,111
KERALA,2007,Jeep (Government),7,0,7
KERALA,2007,Jeep (Private),102,34,136
KERALA,2007,Car (Government),4,1,5
KERALA,2007,Car (Private),265,69,334
KERALA,2007,Three Wheeler,210,57,267
KERALA,2007,Two Wheeler,1137,114,1251
KERALA,2007,Bicycle,135,4,139
KERALA,2007,Pedestrian,828,200,1028
KERALA,2007,Others (Please Specify),47,8,55
KERALA,2007,Total Deaths (Persons),3220,582,3802
KERALA,2007,Total Truck/Lorry,125,8,133
KERALA,2007,Total Bus,253,71,324
KERALA,2007,Total Tempo/Vans,107,16,123
KERALA,2007,Total Jeep,109,34,143
KERALA,2007,Total Car,269,70,339
KERALA,2008,Truck/Lorry (Government),0,0,0
KERALA,2008,Truck/Lorry (Private),43,7,50
KERALA,2008,Bus (Government),22,7,29
KERALA,2008,Bus (Private),97,22,119
KERALA,2008,Tempo/Vans (Government),0,0,0
KERALA,2008,Tempo/Vans (Private),85,14,99
KERALA,2008,Jeep (Government),1,0,1
KERALA,2008,Jeep (Private),79,20,99
KERALA,2008,Car (Government),0,0,0
KERALA,2008,Car (Private),265,70,335
KERALA,2008,Three Wheeler,259,47,306
KERALA,2008,Two Wheeler,1261,140,1401
KERALA,2008,Bicycle,176,4,180
KERALA,2008,Pedestrian,1026,269,1295
KERALA,2008,Others (Please Specify),18,2,20
KERALA,2008,Total Deaths (Persons),3332,602,3934
KERALA,2008,Total Truck/Lorry,43,7,50
KERALA,2008,Total Bus,119,29,148
KERALA,2008,Total Tempo/Vans,85,14,99
KERALA,2008,Total Jeep,80,20,100
KERALA,2008,Total Car,265,70,335
KERALA,2009,Truck/Lorry (Government),0,0,0
KERALA,2009,Truck/Lorry (Private),91,8,99
KERALA,2009,Bus (Government),34,8,42
KERALA,2009,Bus (Private),91,16,107
KERALA,2009,Tempo/Vans (Government),0,0,0
KERALA,2009,Tempo/Vans (Private),97,2,99
KERALA,2009,Jeep (Government),0,0,0
KERALA,2009,Jeep (Private),74,18,92
KERALA,2009,Car (Government),1,0,1
KERALA,2009,Car (Private),234,60,294
KERALA,2009,Three Wheeler,228,58,286
KERALA,2009,Two Wheeler,1295,148,1443
KERALA,2009,Bicycle,151,1,152
KERALA,2009,Pedestrian,948,253,1201
KERALA,2009,Others (Please Specify),9,0,9
KERALA,2009,Total Deaths (Persons),3253,572,3825
KERALA,2009,Total Truck/Lorry,91,8,99
KERALA,2009,Total Bus,125,24,149
KERALA,2009,Total Tempo/Vans,97,2,99
KERALA,2009,Total Jeep,74,18,92
KERALA,2009,Total Car,235,60,295
KERALA,2010,Truck/Lorry (Government),0,0,0
KERALA,2010,Truck/Lorry (Private),164,18,182
KERALA,2010,Bus (Government),61,19,80
KERALA,2010,Bus (Private),130,40,170
KERALA,2010,Tempo/Vans (Government),0,0,0
KERALA,2010,Tempo/Vans (Private),77,14,91
KERALA,2010,Jeep (Government),3,0,3
KERALA,2010,Jeep (Private),78,26,104
KERALA,2010,Car (Government),0,0,0
KERALA,2010,Car (Private),279,75,354
KERALA,2010,Three Wheeler,217,65,282
KERALA,2010,Two Wheeler,1280,139,1419
KERALA,2010,Bicycle,136,0,136
KERALA,2010,Pedestrian,851,248,1099
KERALA,2010,Others (Please Specify),22,8,30
KERALA,2010,Total Deaths (Persons),3298,652,3950
KERALA,2010,Total Truck/Lorry,164,18,182
KERALA,2010,Total Bus,191,59,250
KERALA,2010,Total Tempo/Vans,77,14,91
KERALA,2010,Total Jeep,81,26,107
KERALA,2010,Total Car,279,75,354
KERALA,2011,Truck/Lorry (Government),1,0,1
KERALA,2011,Truck/Lorry (Private),39,12,51
KERALA,2011,Bus (Government),21,9,30
KERALA,2011,Bus (Private),91,30,121
KERALA,2011,Tempo/Vans (Government),0,0,0
KERALA,2011,Tempo/Vans (Private),73,11,84
KERALA,2011,Jeep (Government),2,0,2
KERALA,2011,Jeep (Private),37,18,55
KERALA,2011,Car (Government),0,0,0
KERALA,2011,Car (Private),249,56,305
KERALA,2011,Three Wheeler,179,61,240
KERALA,2011,Two Wheeler,1556,157,1713
KERALA,2011,Bicycle,141,1,142
KERALA,2011,Pedestrian,1082,278,1360
KERALA,2011,Others (Please Specify),37,4,41
KERALA,2011,Total Deaths (Persons),3508,637,4145
KERALA,2011,Total Truck/Lorry,40,12,52
KERALA,2011,Total Bus,112,39,151
KERALA,2011,Total Tempo/Vans,73,11,84
KERALA,2011,Total Jeep,39,18,57
KERALA,2011,Total Car,249,56,305
KERALA,2012,Truck/Lorry (Government),0,0,0
KERALA,2012,Truck/Lorry (Private),139,17,156
KERALA,2012,Bus (Government),48,10,58
KERALA,2012,Bus (Private),105,20,125
KERALA,2012,Tempo/Vans (Government),0,0,0
KERALA,2012,Tempo/Vans (Private),65,19,84
KERALA,2012,Jeep (Government),4,0,4
KERALA,2012,Jeep (Private),35,8,43
KERALA,2012,Car (Government),5,0,5
KERALA,2012,Car (Private),224,90,314
KERALA,2012,Three Wheeler,249,39,288
KERALA,2012,Two Wheeler,1501,180,1681
KERALA,2012,Bicycle,131,3,134
KERALA,2012,Pedestrian,1047,298,1345
KERALA,2012,Others (Please Specify),42,7,49
KERALA,2012,Total Deaths (Persons),3595,691,4286
KERALA,2012,Total Truck/Lorry,139,17,156
KERALA,2012,Total Bus,153,30,183
KERALA,2012,Total Tempo/Vans,65,19,84
KERALA,2012,Total Jeep,39,8,47
KERALA,2012,Total Car,229,90,319
MADHYA PRADESH,2001,Truck/Lorry (Government),44,2,46
MADHYA PRADESH,2001,Truck/Lorry (Private),977,205,1182
MADHYA PRADESH,2001,Bus (Government),240,68,308
MADHYA PRADESH,2001,Bus (Private),89,42,131
MADHYA PRADESH,2001,Tempo/Vans (Government),5,2,7
MADHYA PRADESH,2001,Tempo/Vans (Private),93,22,115
MADHYA PRADESH,2001,Jeep (Government),29,2,31
MADHYA PRADESH,2001,Jeep (Private),422,112,534
MADHYA PRADESH,2001,Car (Government),3,0,3
MADHYA PRADESH,2001,Car (Private),95,18,113
MADHYA PRADESH,2001,Three Wheeler,68,19,87
MADHYA PRADESH,2001,Two Wheeler,414,53,467
MADHYA PRADESH,2001,Bicycle,92,22,114
MADHYA PRADESH,2001,Pedestrian,363,92,455
MADHYA PRADESH,2001,Others (Please Specify),380,82,462
MADHYA PRADESH,2001,Total Deaths (Persons),3314,741,4055
MADHYA PRADESH,2001,Total Truck/Lorry,1021,207,1228
MADHYA PRADESH,2001,Total Bus,329,110,439
MADHYA PRADESH,2001,Total Tempo/Vans,98,24,122
MADHYA PRADESH,2001,Total Jeep,451,114,565
MADHYA PRADESH,2001,Total Car,98,18,116
MADHYA PRADESH,2002,Truck/Lorry (Government),37,7,44
MADHYA PRADESH,2002,Truck/Lorry (Private),1004,143,1147
MADHYA PRADESH,2002,Bus (Government),172,33,205
MADHYA PRADESH,2002,Bus (Private),239,72,311
MADHYA PRADESH,2002,Tempo/Vans (Government),11,2,13
MADHYA PRADESH,2002,Tempo/Vans (Private),122,29,151
MADHYA PRADESH,2002,Jeep (Government),8,0,8
MADHYA PRADESH,2002,Jeep (Private),457,114,571
MADHYA PRADESH,2002,Car (Government),4,0,4
MADHYA PRADESH,2002,Car (Private),124,20,144
MADHYA PRADESH,2002,Three Wheeler,117,8,125
MADHYA PRADESH,2002,Two Wheeler,582,69,651
MADHYA PRADESH,2002,Bicycle,79,3,82
MADHYA PRADESH,2002,Pedestrian,320,81,401
MADHYA PRADESH,2002,Others (Please Specify),531,93,624
MADHYA PRADESH,2002,Total Deaths (Persons),3807,674,4481
MADHYA PRADESH,2002,Total Truck/Lorry,1041,150,1191
MADHYA PRADESH,2002,Total Bus,411,105,516
MADHYA PRADESH,2002,Total Tempo/Vans,133,31,164
MADHYA PRADESH,2002,Total Jeep,465,114,579
MADHYA PRADESH,2002,Total Car,128,20,148
MADHYA PRADESH,2003,Truck/Lorry (Government),12,2,14
MADHYA PRADESH,2003,Truck/Lorry (Private),989,146,1135
MADHYA PRADESH,2003,Bus (Government),3,0,3
MADHYA PRADESH,2003,Bus (Private),403,95,498
MADHYA PRADESH,2003,Tempo/Vans (Government),3,0,3
MADHYA PRADESH,2003,Tempo/Vans (Private),125,28,153
MADHYA PRADESH,2003,Jeep (Government),13,6,19
MADHYA PRADESH,2003,Jeep (Private),449,84,533
MADHYA PRADESH,2003,Car (Government),5,0,5
MADHYA PRADESH,2003,Car (Private),171,28,199
MADHYA PRADESH,2003,Three Wheeler,106,6,112
MADHYA PRADESH,2003,Two Wheeler,634,82,716
MADHYA PRADESH,2003,Bicycle,74,5,79
MADHYA PRADESH,2003,Pedestrian,361,62,423
MADHYA PRADESH,2003,Others (Please Specify),521,99,620
MADHYA PRADESH,2003,Total Deaths (Persons),3869,643,4512
MADHYA PRADESH,2003,Total Truck/Lorry,1001,148,1149
MADHYA PRADESH,2003,Total Bus,406,95,501
MADHYA PRADESH,2003,Total Tempo/Vans,128,28,156
MADHYA PRADESH,2003,Total Jeep,462,90,552
MADHYA PRADESH,2003,Total Car,176,28,204
MADHYA PRADESH,2004,Truck/Lorry (Government),12,2,14
MADHYA PRADESH,2004,Truck/Lorry (Private),958,117,1075
MADHYA PRADESH,2004,Bus (Government),140,30,170
MADHYA PRADESH,2004,Bus (Private),253,64,317
MADHYA PRADESH,2004,Tempo/Vans (Government),3,0,3
MADHYA PRADESH,2004,Tempo/Vans (Private),183,31,214
MADHYA PRADESH,2004,Jeep (Government),10,2,12
MADHYA PRADESH,2004,Jeep (Private),491,110,601
MADHYA PRADESH,2004,Car (Government),10,2,12
MADHYA PRADESH,2004,Car (Private),146,45,191
MADHYA PRADESH,2004,Three Wheeler,77,14,91
MADHYA PRADESH,2004,Two Wheeler,664,98,762
MADHYA PRADESH,2004,Bicycle,114,5,119
MADHYA PRADESH,2004,Pedestrian,493,105,598
MADHYA PRADESH,2004,Others (Please Specify),593,144,737
MADHYA PRADESH,2004,Total Deaths (Persons),4147,769,4916
MADHYA PRADESH,2004,Total Truck/Lorry,970,119,1089
MADHYA PRADESH,2004,Total Bus,393,94,487
MADHYA PRADESH,2004,Total Tempo/Vans,186,31,217
MADHYA PRADESH,2004,Total Jeep,501,112,613
MADHYA PRADESH,2004,Total Car,156,47,203
MADHYA PRADESH,2005,Truck/Lorry (Government),8,0,8
MADHYA PRADESH,2005,Truck/Lorry (Private),1146,144,1290
MADHYA PRADESH,2005,Bus (Government),113,23,136
MADHYA PRADESH,2005,Bus (Private),367,81,448
MADHYA PRADESH,2005,Tempo/Vans (Government),1,0,1
MADHYA PRADESH,2005,Tempo/Vans (Private),175,27,202
MADHYA PRADESH,2005,Jeep (Government),8,0,8
MADHYA PRADESH,2005,Jeep (Private),608,105,713
MADHYA PRADESH,2005,Car (Government),0,0,0
MADHYA PRADESH,2005,Car (Private),172,33,205
MADHYA PRADESH,2005,Three Wheeler,90,16,106
MADHYA PRADESH,2005,Two Wheeler,846,81,927
MADHYA PRADESH,2005,Bicycle,97,7,104
MADHYA PRADESH,2005,Pedestrian,435,98,533
MADHYA PRADESH,2005,Others (Please Specify),567,113,680
MADHYA PRADESH,2005,Total Deaths (Persons),4633,728,5361
MADHYA PRADESH,2005,Total Truck/Lorry,1154,144,1298
MADHYA PRADESH,2005,Total Bus,480,104,584
MADHYA PRADESH,2005,Total Tempo/Vans,176,27,203
MADHYA PRADESH,2005,Total Jeep,616,105,721
MADHYA PRADESH,2005,Total Car,172,33,205
MADHYA PRADESH,2006,Truck/Lorry (Government),14,1,15
MADHYA PRADESH,2006,Truck/Lorry (Private),1189,146,1335
MADHYA PRADESH,2006,Bus (Government),3,1,4
MADHYA PRADESH,2006,Bus (Private),460,119,579
MADHYA PRADESH,2006,Tempo/Vans (Government),1,0,1
MADHYA PRADESH,2006,Tempo/Vans (Private),128,23,151
MADHYA PRADESH,2006,Jeep (Government),15,3,18
MADHYA PRADESH,2006,Jeep (Private),476,104,580
MADHYA PRADESH,2006,Car (Government),2,0,2
MADHYA PRADESH,2006,Car (Private),312,57,369
MADHYA PRADESH,2006,Three Wheeler,107,18,125
MADHYA PRADESH,2006,Two Wheeler,869,132,1001
MADHYA PRADESH,2006,Bicycle,98,12,110
MADHYA PRADESH,2006,Pedestrian,418,76,494
MADHYA PRADESH,2006,Others (Please Specify),690,124,814
MADHYA PRADESH,2006,Total Deaths (Persons),4782,816,5598
MADHYA PRADESH,2006,Total Truck/Lorry,1203,147,1350
MADHYA PRADESH,2006,Total Bus,463,120,583
MADHYA PRADESH,2006,Total Tempo/Vans,129,23,152
MADHYA PRADESH,2006,Total Jeep,491,107,598
MADHYA PRADESH,2006,Total Car,314,57,371
MADHYA PRADESH,2007,Truck/Lorry (Government),4,0,4
MADHYA PRADESH,2007,Truck/Lorry (Private),1405,193,1598
MADHYA PRADESH,2007,Bus (Government),4,1,5
MADHYA PRADESH,2007,Bus (Private),566,129,695
MADHYA PRADESH,2007,Tempo/Vans (Government),5,0,5
MADHYA PRADESH,2007,Tempo/Vans (Private),153,37,190
MADHYA PRADESH,2007,Jeep (Government),23,4,27
MADHYA PRADESH,2007,Jeep (Private),508,112,620
MADHYA PRADESH,2007,Car (Government),2,0,2
MADHYA PRADESH,2007,Car (Private),291,48,339
MADHYA PRADESH,2007,Three Wheeler,137,21,158
MADHYA PRADESH,2007,Two Wheeler,1105,135,1240
MADHYA PRADESH,2007,Bicycle,71,12,83
MADHYA PRADESH,2007,Pedestrian,522,95,617
MADHYA PRADESH,2007,Others (Please Specify),660,103,763
MADHYA PRADESH,2007,Total Deaths (Persons),5456,890,6346
MADHYA PRADESH,2007,Total Truck/Lorry,1409,193,1602
MADHYA PRADESH,2007,Total Bus,570,130,700
MADHYA PRADESH,2007,Total Tempo/Vans,158,37,195
MADHYA PRADESH,2007,Total Jeep,531,116,647
MADHYA PRADESH,2007,Total Car,293,48,341
MADHYA PRADESH,2008,Truck/Lorry (Government),16,5,21
MADHYA PRADESH,2008,Truck/Lorry (Private),1199,148,1347
MADHYA PRADESH,2008,Bus (Government),26,5,31
MADHYA PRADESH,2008,Bus (Private),570,128,698
MADHYA PRADESH,2008,Tempo/Vans (Government),11,0,11
MADHYA PRADESH,2008,Tempo/Vans (Private),275,57,332
MADHYA PRADESH,2008,Jeep (Government),11,0,11
MADHYA PRADESH,2008,Jeep (Private),735,124,859
MADHYA PRADESH,2008,Car (Government),14,7,21
MADHYA PRADESH,2008,Car (Private),284,65,349
MADHYA PRADESH,2008,Three Wheeler,175,31,206
MADHYA PRADESH,2008,Two Wheeler,1597,197,1794
MADHYA PRADESH,2008,Bicycle,227,28,255
MADHYA PRADESH,2008,Pedestrian,758,151,909
MADHYA PRADESH,2008,Others (Please Specify),548,122,670
MADHYA PRADESH,2008,Total Deaths (Persons),6446,1068,7514
MADHYA PRADESH,2008,Total Truck/Lorry,1215,153,1368
MADHYA PRADESH,2008,Total Bus,596,133,729
MADHYA PRADESH,2008,Total Tempo/Vans,286,57,343
MADHYA PRADESH,2008,Total Jeep,746,124,870
MADHYA PRADESH,2008,Total Car,298,72,370
MADHYA PRADESH,2009,Truck/Lorry (Government),1,0,1
MADHYA PRADESH,2009,Truck/Lorry (Private),1195,160,1355
MADHYA PRADESH,2009,Bus (Government),0,0,0
MADHYA PRADESH,2009,Bus (Private),598,141,739
MADHYA PRADESH,2009,Tempo/Vans (Government),3,0,3
MADHYA PRADESH,2009,Tempo/Vans (Private),317,61,378
MADHYA PRADESH,2009,Jeep (Government),13,0,13
MADHYA PRADESH,2009,Jeep (Private),611,131,742
MADHYA PRADESH,2009,Car (Government),2,2,4
MADHYA PRADESH,2009,Car (Private),376,92,468
MADHYA PRADESH,2009,Three Wheeler,99,36,135
MADHYA PRADESH,2009,Two Wheeler,1610,203,1813
MADHYA PRADESH,2009,Bicycle,277,18,295
MADHYA PRADESH,2009,Pedestrian,991,205,1196
MADHYA PRADESH,2009,Others (Please Specify),705,193,898
MADHYA PRADESH,2009,Total Deaths (Persons),6798,1242,8040
MADHYA PRADESH,2009,Total Truck/Lorry,1196,160,1356
MADHYA PRADESH,2009,Total Bus,598,141,739
MADHYA PRADESH,2009,Total Tempo/Vans,320,61,381
MADHYA PRADESH,2009,Total Jeep,624,131,755
MADHYA PRADESH,2009,Total Car,378,94,472
MADHYA PRADESH,2010,Truck/Lorry (Government),18,1,19
MADHYA PRADESH,2010,Truck/Lorry (Private),1428,182,1610
MADHYA PRADESH,2010,Bus (Government),47,14,61
MADHYA PRADESH,2010,Bus (Private),475,95,570
MADHYA PRADESH,2010,Tempo/Vans (Government),3,1,4
MADHYA PRADESH,2010,Tempo/Vans (Private),225,43,268
MADHYA PRADESH,2010,Jeep (Government),10,4,14
MADHYA PRADESH,2010,Jeep (Private),777,156,933
MADHYA PRADESH,2010,Car (Government),4,0,4
MADHYA PRADESH,2010,Car (Private),499,91,590
MADHYA PRADESH,2010,Three Wheeler,140,20,160
MADHYA PRADESH,2010,Two Wheeler,1949,227,2176
MADHYA PRADESH,2010,Bicycle,138,12,150
MADHYA PRADESH,2010,Pedestrian,800,157,957
MADHYA PRADESH,2010,Others (Please Specify),871,152,1023
MADHYA PRADESH,2010,Total Deaths (Persons),7384,1155,8539
MADHYA PRADESH,2010,Total Truck/Lorry,1446,183,1629
MADHYA PRADESH,2010,Total Bus,522,109,631
MADHYA PRADESH,2010,Total Tempo/Vans,228,44,272
MADHYA PRADESH,2010,Total Jeep,787,160,947
MADHYA PRADESH,2010,Total Car,503,91,594
MADHYA PRADESH,2011,Truck/Lorry (Government),14,3,17
MADHYA PRADESH,2011,Truck/Lorry (Private),1441,159,1600
MADHYA PRADESH,2011,Bus (Government),24,6,30
MADHYA PRADESH,2011,Bus (Private),533,102,635
MADHYA PRADESH,2011,Tempo/Vans (Government),22,2,24
MADHYA PRADESH,2011,Tempo/Vans (Private),253,59,312
MADHYA PRADESH,2011,Jeep (Government),6,1,7
MADHYA PRADESH,2011,Jeep (Private),650,153,803
MADHYA PRADESH,2011,Car (Government),9,4,13
MADHYA PRADESH,2011,Car (Private),496,92,588
MADHYA PRADESH,2011,Three Wheeler,156,34,190
MADHYA PRADESH,2011,Two Wheeler,1675,246,1921
MADHYA PRADESH,2011,Bicycle,150,18,168
MADHYA PRADESH,2011,Pedestrian,737,201,938
MADHYA PRADESH,2011,Others (Please Specify),862,148,1010
MADHYA PRADESH,2011,Total Deaths (Persons),7028,1228,8256
MADHYA PRADESH,2011,Total Truck/Lorry,1455,162,1617
MADHYA PRADESH,2011,Total Bus,557,108,665
MADHYA PRADESH,2011,Total Tempo/Vans,275,61,336
MADHYA PRADESH,2011,Total Jeep,656,154,810
MADHYA PRADESH,2011,Total Car,505,96,601
MADHYA PRADESH,2012,Truck/Lorry (Government),15,0,15
MADHYA PRADESH,2012,Truck/Lorry (Private),1337,166,1503
MADHYA PRADESH,2012,Bus (Government),5,1,6
MADHYA PRADESH,2012,Bus (Private),539,120,659
MADHYA PRADESH,2012,Tempo/Vans (Government),3,1,4
MADHYA PRADESH,2012,Tempo/Vans (Private),241,43,284
MADHYA PRADESH,2012,Jeep (Government),8,0,8
MADHYA PRADESH,2012,Jeep (Private),609,140,749
MADHYA PRADESH,2012,Car (Government),5,0,5
MADHYA PRADESH,2012,Car (Private),437,86,523
MADHYA PRADESH,2012,Three Wheeler,139,34,173
MADHYA PRADESH,2012,Two Wheeler,1964,254,2218
MADHYA PRADESH,2012,Bicycle,136,13,149
MADHYA PRADESH,2012,Pedestrian,942,200,1142
MADHYA PRADESH,2012,Others (Please Specify),890,178,1068
MADHYA PRADESH,2012,Total Deaths (Persons),7270,1236,8506
MADHYA PRADESH,2012,Total Truck/Lorry,1352,166,1518
MADHYA PRADESH,2012,Total Bus,544,121,665
MADHYA PRADESH,2012,Total Tempo/Vans,244,44,288
MADHYA PRADESH,2012,Total Jeep,617,140,757
MADHYA PRADESH,2012,Total Car,442,86,528
MAHARASHTRA,2001,Truck/Lorry (Government),25,3,28
MAHARASHTRA,2001,Truck/Lorry (Private),2142,357,2499
MAHARASHTRA,2001,Bus (Government),337,86,423
MAHARASHTRA,2001,Bus (Private),301,82,383
MAHARASHTRA,2001,Tempo/Vans (Government),39,7,46
MAHARASHTRA,2001,Tempo/Vans (Private),619,138,757
MAHARASHTRA,2001,Jeep (Government),38,5,43
MAHARASHTRA,2001,Jeep (Private),1181,361,1542
MAHARASHTRA,2001,Car (Government),9,5,14
MAHARASHTRA,2001,Car (Private),526,117,643
MAHARASHTRA,2001,Three Wheeler,415,88,503
MAHARASHTRA,2001,Two Wheeler,1498,156,1654
MAHARASHTRA,2001,Bicycle,293,29,322
MAHARASHTRA,2001,Pedestrian,977,268,1245
MAHARASHTRA,2001,Others (Please Specify),286,34,320
MAHARASHTRA,2001,Total Deaths (Persons),8686,1736,10422
MAHARASHTRA,2001,Total Truck/Lorry,2167,360,2527
MAHARASHTRA,2001,Total Bus,638,168,806
MAHARASHTRA,2001,Total Tempo/Vans,658,145,803
MAHARASHTRA,2001,Total Jeep,1219,366,1585
MAHARASHTRA,2001,Total Car,535,122,657
MAHARASHTRA,2002,Truck/Lorry (Government),4,0,4
MAHARASHTRA,2002,Truck/Lorry (Private),1996,235,2231
MAHARASHTRA,2002,Bus (Government),316,60,376
MAHARASHTRA,2002,Bus (Private),225,69,294
MAHARASHTRA,2002,Tempo/Vans (Government),21,0,21
MAHARASHTRA,2002,Tempo/Vans (Private),622,137,759
MAHARASHTRA,2002,Jeep (Government),30,5,35
MAHARASHTRA,2002,Jeep (Private),1180,275,1455
MAHARASHTRA,2002,Car (Government),9,4,13
MAHARASHTRA,2002,Car (Private),562,100,662
MAHARASHTRA,2002,Three Wheeler,466,94,560
MAHARASHTRA,2002,Two Wheeler,1658,219,1877
MAHARASHTRA,2002,Bicycle,341,25,366
MAHARASHTRA,2002,Pedestrian,991,211,1202
MAHARASHTRA,2002,Others (Please Specify),358,49,407
MAHARASHTRA,2002,Total Deaths (Persons),8779,1483,10262
MAHARASHTRA,2002,Total Truck/Lorry,2000,235,2235
MAHARASHTRA,2002,Total Bus,541,129,670
MAHARASHTRA,2002,Total Tempo/Vans,643,137,780
MAHARASHTRA,2002,Total Jeep,1210,280,1490
MAHARASHTRA,2002,Total Car,571,104,675
MAHARASHTRA,2003,Truck/Lorry (Government),17,2,19
MAHARASHTRA,2003,Truck/Lorry (Private),1870,191,2061
MAHARASHTRA,2003,Bus (Government),292,61,353
MAHARASHTRA,2003,Bus (Private),272,75,347
MAHARASHTRA,2003,Tempo/Vans (Government),12,1,13
MAHARASHTRA,2003,Tempo/Vans (Private),615,97,712
MAHARASHTRA,2003,Jeep (Government),43,3,46
MAHARASHTRA,2003,Jeep (Private),1233,220,1453
MAHARASHTRA,2003,Car (Government),6,0,6
MAHARASHTRA,2003,Car (Private),585,120,705
MAHARASHTRA,2003,Three Wheeler,443,63,506
MAHARASHTRA,2003,Two Wheeler,1893,220,2113
MAHARASHTRA,2003,Bicycle,278,25,303
MAHARASHTRA,2003,Pedestrian,926,228,1154
MAHARASHTRA,2003,Others (Please Specify),387,66,453
MAHARASHTRA,2003,Total Deaths (Persons),8872,1372,10244
MAHARASHTRA,2003,Total Truck/Lorry,1887,193,2080
MAHARASHTRA,2003,Total Bus,564,136,700
MAHARASHTRA,2003,Total Tempo/Vans,627,98,725
MAHARASHTRA,2003,Total Jeep,1276,223,1499
MAHARASHTRA,2003,Total Car,591,120,711
MAHARASHTRA,2004,Truck/Lorry (Government),15,0,15
MAHARASHTRA,2004,Truck/Lorry (Private),1933,236,2169
MAHARASHTRA,2004,Bus (Government),249,66,315
MAHARASHTRA,2004,Bus (Private),211,71,282
MAHARASHTRA,2004,Tempo/Vans (Government),26,7,33
MAHARASHTRA,2004,Tempo/Vans (Private),576,90,666
MAHARASHTRA,2004,Jeep (Government),13,0,13
MAHARASHTRA,2004,Jeep (Private),1281,217,1498
MAHARASHTRA,2004,Car (Government),14,6,20
MAHARASHTRA,2004,Car (Private),552,99,651
MAHARASHTRA,2004,Three Wheeler,466,94,560
MAHARASHTRA,2004,Two Wheeler,2157,212,2369
MAHARASHTRA,2004,Bicycle,253,11,264
MAHARASHTRA,2004,Pedestrian,1009,247,1256
MAHARASHTRA,2004,Others (Please Specify),436,58,494
MAHARASHTRA,2004,Total Deaths (Persons),9191,1414,10605
MAHARASHTRA,2004,Total Truck/Lorry,1948,236,2184
MAHARASHTRA,2004,Total Bus,460,137,597
MAHARASHTRA,2004,Total Tempo/Vans,602,97,699
MAHARASHTRA,2004,Total Jeep,1294,217,1511
MAHARASHTRA,2004,Total Car,566,105,671
MAHARASHTRA,2005,Truck/Lorry (Government),8,3,11
MAHARASHTRA,2005,Truck/Lorry (Private),2023,271,2294
MAHARASHTRA,2005,Bus (Government),222,53,275
MAHARASHTRA,2005,Bus (Private),198,42,240
MAHARASHTRA,2005,Tempo/Vans (Government),10,1,11
MAHARASHTRA,2005,Tempo/Vans (Private),625,117,742
MAHARASHTRA,2005,Jeep (Government),15,2,17
MAHARASHTRA,2005,Jeep (Private),1220,240,1460
MAHARASHTRA,2005,Car (Government),4,1,5
MAHARASHTRA,2005,Car (Private),551,117,668
MAHARASHTRA,2005,Three Wheeler,481,77,558
MAHARASHTRA,2005,Two Wheeler,2204,235,2439
MAHARASHTRA,2005,Bicycle,223,14,237
MAHARASHTRA,2005,Pedestrian,994,230,1224
MAHARASHTRA,2005,Others (Please Specify),392,40,432
MAHARASHTRA,2005,Total Deaths (Persons),9170,1443,10613
MAHARASHTRA,2005,Total Truck/Lorry,2031,274,2305
MAHARASHTRA,2005,Total Bus,420,95,515
MAHARASHTRA,2005,Total Tempo/Vans,635,118,753
MAHARASHTRA,2005,Total Jeep,1235,242,1477
MAHARASHTRA,2005,Total Car,555,118,673
MAHARASHTRA,2006,Truck/Lorry (Government),14,3,17
MAHARASHTRA,2006,Truck/Lorry (Private),2241,272,2513
MAHARASHTRA,2006,Bus (Government),266,77,343
MAHARASHTRA,2006,Bus (Private),242,66,308
MAHARASHTRA,2006,Tempo/Vans (Government),21,2,23
MAHARASHTRA,2006,Tempo/Vans (Private),640,87,727
MAHARASHTRA,2006,Jeep (Government),8,2,10
MAHARASHTRA,2006,Jeep (Private),1187,242,1429
MAHARASHTRA,2006,Car (Government),0,0,0
MAHARASHTRA,2006,Car (Private),745,137,882
MAHARASHTRA,2006,Three Wheeler,468,103,571
MAHARASHTRA,2006,Two Wheeler,2666,277,2943
MAHARASHTRA,2006,Bicycle,275,20,295
MAHARASHTRA,2006,Pedestrian,1248,230,1478
MAHARASHTRA,2006,Others (Please Specify),339,56,395
MAHARASHTRA,2006,Total Deaths (Persons),10360,1574,11934
MAHARASHTRA,2006,Total Truck/Lorry,2255,275,2530
MAHARASHTRA,2006,Total Bus,508,143,651
MAHARASHTRA,2006,Total Tempo/Vans,661,89,750
MAHARASHTRA,2006,Total Jeep,1195,244,1439
MAHARASHTRA,2006,Total Car,745,137,882
MAHARASHTRA,2007,Truck/Lorry (Government),32,11,43
MAHARASHTRA,2007,Truck/Lorry (Private),2073,210,2283
MAHARASHTRA,2007,Bus (Government),268,63,331
MAHARASHTRA,2007,Bus (Private),203,30,233
MAHARASHTRA,2007,Tempo/Vans (Government),4,3,7
MAHARASHTRA,2007,Tempo/Vans (Private),687,87,774
MAHARASHTRA,2007,Jeep (Government),19,5,24
MAHARASHTRA,2007,Jeep (Private),1187,238,1425
MAHARASHTRA,2007,Car (Government),0,0,0
MAHARASHTRA,2007,Car (Private),742,143,885
MAHARASHTRA,2007,Three Wheeler,571,151,722
MAHARASHTRA,2007,Two Wheeler,3018,345,3363
MAHARASHTRA,2007,Bicycle,292,20,312
MAHARASHTRA,2007,Pedestrian,1431,317,1748
MAHARASHTRA,2007,Others (Please Specify),405,61,466
MAHARASHTRA,2007,Total Deaths (Persons),10932,1684,12616
MAHARASHTRA,2007,Total Truck/Lorry,2105,221,2326
MAHARASHTRA,2007,Total Bus,471,93,564
MAHARASHTRA,2007,Total Tempo/Vans,691,90,781
MAHARASHTRA,2007,Total Jeep,1206,243,1449
MAHARASHTRA,2007,Total Car,742,143,885
MAHARASHTRA,2008,Truck/Lorry (Government),18,2,20
MAHARASHTRA,2008,Truck/Lorry (Private),2145,220,2365
MAHARASHTRA,2008,Bus (Government),239,63,302
MAHARASHTRA,2008,Bus (Private),215,56,271
MAHARASHTRA,2008,Tempo/Vans (Government),8,0,8
MAHARASHTRA,2008,Tempo/Vans (Private),660,104,764
MAHARASHTRA,2008,Jeep (Government),12,1,13
MAHARASHTRA,2008,Jeep (Private),1075,242,1317
MAHARASHTRA,2008,Car (Government),25,10,35
MAHARASHTRA,2008,Car (Private),778,149,927
MAHARASHTRA,2008,Three Wheeler,633,142,775
MAHARASHTRA,2008,Two Wheeler,3152,421,3573
MAHARASHTRA,2008,Bicycle,271,22,293
MAHARASHTRA,2008,Pedestrian,1478,322,1800
MAHARASHTRA,2008,Others (Please Specify),429,65,494
MAHARASHTRA,2008,Total Deaths (Persons),11138,1819,12957
MAHARASHTRA,2008,Total Truck/Lorry,2163,222,2385
MAHARASHTRA,2008,Total Bus,454,119,573
MAHARASHTRA,2008,Total Tempo/Vans,668,104,772
MAHARASHTRA,2008,Total Jeep,1087,243,1330
MAHARASHTRA,2008,Total Car,803,159,962
MAHARASHTRA,2009,Truck/Lorry (Government),26,1,27
MAHARASHTRA,2009,Truck/Lorry (Private),2098,238,2336
MAHARASHTRA,2009,Bus (Government),182,51,233
MAHARASHTRA,2009,Bus (Private),184,33,217
MAHARASHTRA,2009,Tempo/Vans (Government),51,13,64
MAHARASHTRA,2009,Tempo/Vans (Private),602,97,699
MAHARASHTRA,2009,Jeep (Government),30,13,43
MAHARASHTRA,2009,Jeep (Private),1090,212,1302
MAHARASHTRA,2009,Car (Government),1,1,2
MAHARASHTRA,2009,Car (Private),795,183,978
MAHARASHTRA,2009,Three Wheeler,615,105,720
MAHARASHTRA,2009,Two Wheeler,3442,376,3818
MAHARASHTRA,2009,Bicycle,263,15,278
MAHARASHTRA,2009,Pedestrian,1428,314,1742
MAHARASHTRA,2009,Others (Please Specify),532,43,575
MAHARASHTRA,2009,Total Deaths (Persons),11339,1695,13034
MAHARASHTRA,2009,Total Truck/Lorry,2124,239,2363
MAHARASHTRA,2009,Total Bus,366,84,450
MAHARASHTRA,2009,Total Tempo/Vans,653,110,763
MAHARASHTRA,2009,Total Jeep,1120,225,1345
MAHARASHTRA,2009,Total Car,796,184,980
MAHARASHTRA,2010,Truck/Lorry (Government),28,5,33
MAHARASHTRA,2010,Truck/Lorry (Private),2105,225,2330
MAHARASHTRA,2010,Bus (Government),212,39,251
MAHARASHTRA,2010,Bus (Private),228,53,281
MAHARASHTRA,2010,Tempo/Vans (Government),5,2,7
MAHARASHTRA,2010,Tempo/Vans (Private),655,87,742
MAHARASHTRA,2010,Jeep (Government),17,1,18
MAHARASHTRA,2010,Jeep (Private),1184,211,1395
MAHARASHTRA,2010,Car (Government),4,1,5
MAHARASHTRA,2010,Car (Private),942,186,1128
MAHARASHTRA,2010,Three Wheeler,656,127,783
MAHARASHTRA,2010,Two Wheeler,3856,453,4309
MAHARASHTRA,2010,Bicycle,257,11,268
MAHARASHTRA,2010,Pedestrian,1671,313,1984
MAHARASHTRA,2010,Others (Please Specify),470,59,529
MAHARASHTRA,2010,Total Deaths (Persons),12290,1773,14063
MAHARASHTRA,2010,Total Truck/Lorry,2133,230,2363
MAHARASHTRA,2010,Total Bus,440,92,532
MAHARASHTRA,2010,Total Tempo/Vans,660,89,749
MAHARASHTRA,2010,Total Jeep,1201,212,1413
MAHARASHTRA,2010,Total Car,946,187,1133
MAHARASHTRA,2011,Truck/Lorry (Government),7,1,8
MAHARASHTRA,2011,Truck/Lorry (Private),1994,253,2247
MAHARASHTRA,2011,Bus (Government),304,56,360
MAHARASHTRA,2011,Bus (Private),258,67,325
MAHARASHTRA,2011,Tempo/Vans (Government),6,1,7
MAHARASHTRA,2011,Tempo/Vans (Private),855,106,961
MAHARASHTRA,2011,Jeep (Government),16,1,17
MAHARASHTRA,2011,Jeep (Private),993,170,1163
MAHARASHTRA,2011,Car (Government),6,0,6
MAHARASHTRA,2011,Car (Private),1018,197,1215
MAHARASHTRA,2011,Three Wheeler,570,152,722
MAHARASHTRA,2011,Two Wheeler,3598,471,4069
MAHARASHTRA,2011,Bicycle,177,12,189
MAHARASHTRA,2011,Pedestrian,1284,283,1567
MAHARASHTRA,2011,Others (Please Specify),739,85,824
MAHARASHTRA,2011,Total Deaths (Persons),11825,1855,13680
MAHARASHTRA,2011,Total Truck/Lorry,2001,254,2255
MAHARASHTRA,2011,Total Bus,562,123,685
MAHARASHTRA,2011,Total Tempo/Vans,861,107,968
MAHARASHTRA,2011,Total Jeep,1009,171,1180
MAHARASHTRA,2011,Total Car,1024,197,1221
MAHARASHTRA,2012,Truck/Lorry (Government),12,1,13
MAHARASHTRA,2012,Truck/Lorry (Private),2054,239,2293
MAHARASHTRA,2012,Bus (Government),236,57,293
MAHARASHTRA,2012,Bus (Private),212,40,252
MAHARASHTRA,2012,Tempo/Vans (Government),3,1,4
MAHARASHTRA,2012,Tempo/Vans (Private),819,109,928
MAHARASHTRA,2012,Jeep (Government),7,0,7
MAHARASHTRA,2012,Jeep (Private),1011,153,1164
MAHARASHTRA,2012,Car (Government),4,2,6
MAHARASHTRA,2012,Car (Private),1018,222,1240
MAHARASHTRA,2012,Three Wheeler,535,98,633
MAHARASHTRA,2012,Two Wheeler,4022,462,4484
MAHARASHTRA,2012,Bicycle,212,12,224
MAHARASHTRA,2012,Pedestrian,1377,327,1704
MAHARASHTRA,2012,Others (Please Specify),598,93,691
MAHARASHTRA,2012,Total Deaths (Persons),12120,1816,13936
MAHARASHTRA,2012,Total Truck/Lorry,2066,240,2306
MAHARASHTRA,2012,Total Bus,448,97,545
MAHARASHTRA,2012,Total Tempo/Vans,822,110,932
MAHARASHTRA,2012,Total Jeep,1018,153,1171
MAHARASHTRA,2012,Total Car,1022,224,1246
MANIPUR,2001,Truck/Lorry (Government),4,0,4
MANIPUR,2001,Truck/Lorry (Private),28,3,31
MANIPUR,2001,Bus (Government),0,0,0
MANIPUR,2001,Bus (Private),11,6,17
MANIPUR,2001,Tempo/Vans (Government),0,0,0
MANIPUR,2001,Tempo/Vans (Private),0,0,0
MANIPUR,2001,Jeep (Government),0,1,1
MANIPUR,2001,Jeep (Private),5,4,9
MANIPUR,2001,Car (Government),0,0,0
MANIPUR,2001,Car (Private),2,0,2
MANIPUR,2001,Three Wheeler,0,0,0
MANIPUR,2001,Two Wheeler,10,0,10
MANIPUR,2001,Bicycle,1,0,1
MANIPUR,2001,Pedestrian,6,3,9
MANIPUR,2001,Others (Please Specify),4,0,4
MANIPUR,2001,Total Deaths (Persons),71,17,88
MANIPUR,2001,Total Truck/Lorry,32,3,35
MANIPUR,2001,Total Bus,11,6,17
MANIPUR,2001,Total Tempo/Vans,0,0,0
MANIPUR,2001,Total Jeep,5,5,10
MANIPUR,2001,Total Car,2,0,2
MANIPUR,2002,Truck/Lorry (Government),3,1,4
MANIPUR,2002,Truck/Lorry (Private),15,5,20
MANIPUR,2002,Bus (Government),0,0,0
MANIPUR,2002,Bus (Private),21,13,34
MANIPUR,2002,Tempo/Vans (Government),0,0,0
MANIPUR,2002,Tempo/Vans (Private),6,0,6
MANIPUR,2002,Jeep (Government),0,0,0
MANIPUR,2002,Jeep (Private),3,1,4
MANIPUR,2002,Car (Government),0,0,0
MANIPUR,2002,Car (Private),0,0,0
MANIPUR,2002,Three Wheeler,1,0,1
MANIPUR,2002,Two Wheeler,27,4,31
MANIPUR,2002,Bicycle,4,2,6
MANIPUR,2002,Pedestrian,9,1,10
MANIPUR,2002,Others (Please Specify),3,1,4
MANIPUR,2002,Total Deaths (Persons),92,28,120
MANIPUR,2002,Total Truck/Lorry,18,6,24
MANIPUR,2002,Total Bus,21,13,34
MANIPUR,2002,Total Tempo/Vans,6,0,6
MANIPUR,2002,Total Jeep,3,1,4
MANIPUR,2002,Total Car,0,0,0
MANIPUR,2003,Truck/Lorry (Government),0,0,0
MANIPUR,2003,Truck/Lorry (Private),15,8,23
MANIPUR,2003,Bus (Government),0,1,1
MANIPUR,2003,Bus (Private),27,3,30
MANIPUR,2003,Tempo/Vans (Government),0,0,0
MANIPUR,2003,Tempo/Vans (Private),0,0,0
MANIPUR,2003,Jeep (Government),0,0,0
MANIPUR,2003,Jeep (Private),2,0,2
MANIPUR,2003,Car (Government),0,0,0
MANIPUR,2003,Car (Private),4,0,4
MANIPUR,2003,Three Wheeler,1,1,2
MANIPUR,2003,Two Wheeler,24,1,25
MANIPUR,2003,Bicycle,9,1,10
MANIPUR,2003,Pedestrian,16,9,25
MANIPUR,2003,Others (Please Specify),2,0,2
MANIPUR,2003,Total Deaths (Persons),100,24,124
MANIPUR,2003,Total Truck/Lorry,15,8,23
MANIPUR,2003,Total Bus,27,4,31
MANIPUR,2003,Total Tempo/Vans,0,0,0
MANIPUR,2003,Total Jeep,2,0,2
MANIPUR,2003,Total Car,4,0,4
MANIPUR,2004,Truck/Lorry (Government),3,0,3
MANIPUR,2004,Truck/Lorry (Private),31,1,32
MANIPUR,2004,Bus (Government),0,0,0
MANIPUR,2004,Bus (Private),32,9,41
MANIPUR,2004,Tempo/Vans (Government),0,0,0
MANIPUR,2004,Tempo/Vans (Private),0,0,0
MANIPUR,2004,Jeep (Government),0,0,0
MANIPUR,2004,Jeep (Private),7,2,9
MANIPUR,2004,Car (Government),0,0,0
MANIPUR,2004,Car (Private),1,1,2
MANIPUR,2004,Three Wheeler,1,0,1
MANIPUR,2004,Two Wheeler,16,3,19
MANIPUR,2004,Bicycle,0,0,0
MANIPUR,2004,Pedestrian,7,0,7
MANIPUR,2004,Others (Please Specify),4,1,5
MANIPUR,2004,Total Deaths (Persons),102,17,119
MANIPUR,2004,Total Truck/Lorry,34,1,35
MANIPUR,2004,Total Bus,32,9,41
MANIPUR,2004,Total Tempo/Vans,0,0,0
MANIPUR,2004,Total Jeep,7,2,9
MANIPUR,2004,Total Car,1,1,2
MANIPUR,2005,Truck/Lorry (Government),0,0,0
MANIPUR,2005,Truck/Lorry (Private),28,5,33
MANIPUR,2005,Bus (Government),1,0,1
MANIPUR,2005,Bus (Private),22,8,30
MANIPUR,2005,Tempo/Vans (Government),0,0,0
MANIPUR,2005,Tempo/Vans (Private),0,0,0
MANIPUR,2005,Jeep (Government),0,0,0
MANIPUR,2005,Jeep (Private),6,1,7
MANIPUR,2005,Car (Government),0,0,0
MANIPUR,2005,Car (Private),4,0,4
MANIPUR,2005,Three Wheeler,0,0,0
MANIPUR,2005,Two Wheeler,30,2,32
MANIPUR,2005,Bicycle,5,0,5
MANIPUR,2005,Pedestrian,11,11,22
MANIPUR,2005,Others (Please Specify),2,2,4
MANIPUR,2005,Total Deaths (Persons),109,29,138
MANIPUR,2005,Total Truck/Lorry,28,5,33
MANIPUR,2005,Total Bus,23,8,31
MANIPUR,2005,Total Tempo/Vans,0,0,0
MANIPUR,2005,Total Jeep,6,1,7
MANIPUR,2005,Total Car,4,0,4
MANIPUR,2006,Truck/Lorry (Government),6,1,7
MANIPUR,2006,Truck/Lorry (Private),16,4,20
MANIPUR,2006,Bus (Government),0,0,0
MANIPUR,2006,Bus (Private),20,12,32
MANIPUR,2006,Tempo/Vans (Government),0,0,0
MANIPUR,2006,Tempo/Vans (Private),4,0,4
MANIPUR,2006,Jeep (Government),3,0,3
MANIPUR,2006,Jeep (Private),5,5,10
MANIPUR,2006,Car (Government),0,0,0
MANIPUR,2006,Car (Private),1,0,1
MANIPUR,2006,Three Wheeler,1,0,1
MANIPUR,2006,Two Wheeler,31,4,35
MANIPUR,2006,Bicycle,4,4,8
MANIPUR,2006,Pedestrian,17,7,24
MANIPUR,2006,Others (Please Specify),10,2,12
MANIPUR,2006,Total Deaths (Persons),118,39,157
MANIPUR,2006,Total Truck/Lorry,22,5,27
MANIPUR,2006,Total Bus,20,12,32
MANIPUR,2006,Total Tempo/Vans,4,0,4
MANIPUR,2006,Total Jeep,8,5,13
MANIPUR,2006,Total Car,1,0,1
MANIPUR,2007,Truck/Lorry (Government),3,0,3
MANIPUR,2007,Truck/Lorry (Private),27,5,32
MANIPUR,2007,Bus (Government),0,0,0
MANIPUR,2007,Bus (Private),14,6,20
MANIPUR,2007,Tempo/Vans (Government),0,0,0
MANIPUR,2007,Tempo/Vans (Private),0,0,0
MANIPUR,2007,Jeep (Government),2,0,2
MANIPUR,2007,Jeep (Private),5,1,6
MANIPUR,2007,Car (Government),0,0,0
MANIPUR,2007,Car (Private),2,0,2
MANIPUR,2007,Three Wheeler,1,2,3
MANIPUR,2007,Two Wheeler,17,4,21
MANIPUR,2007,Bicycle,6,0,6
MANIPUR,2007,Pedestrian,11,4,15
MANIPUR,2007,Others (Please Specify),4,0,4
MANIPUR,2007,Total Deaths (Persons),92,22,114
MANIPUR,2007,Total Truck/Lorry,30,5,35
MANIPUR,2007,Total Bus,14,6,20
MANIPUR,2007,Total Tempo/Vans,0,0,0
MANIPUR,2007,Total Jeep,7,1,8
MANIPUR,2007,Total Car,2,0,2
MANIPUR,2008,Truck/Lorry (Government),3,0,3
MANIPUR,2008,Truck/Lorry (Private),32,22,54
MANIPUR,2008,Bus (Government),0,0,0
MANIPUR,2008,Bus (Private),16,1,17
MANIPUR,2008,Tempo/Vans (Government),0,0,0
MANIPUR,2008,Tempo/Vans (Private),2,1,3
MANIPUR,2008,Jeep (Government),0,0,0
MANIPUR,2008,Jeep (Private),10,1,11
MANIPUR,2008,Car (Government),0,0,0
MANIPUR,2008,Car (Private),3,1,4
MANIPUR,2008,Three Wheeler,0,0,0
MANIPUR,2008,Two Wheeler,22,1,23
MANIPUR,2008,Bicycle,2,2,4
MANIPUR,2008,Pedestrian,2,2,4
MANIPUR,2008,Others (Please Specify),8,2,10
MANIPUR,2008,Total Deaths (Persons),100,33,133
MANIPUR,2008,Total Truck/Lorry,35,22,57
MANIPUR,2008,Total Bus,16,1,17
MANIPUR,2008,Total Tempo/Vans,2,1,3
MANIPUR,2008,Total Jeep,10,1,11
MANIPUR,2008,Total Car,3,1,4
MANIPUR,2009,Truck/Lorry (Government),2,0,2
MANIPUR,2009,Truck/Lorry (Private),39,9,48
MANIPUR,2009,Bus (Government),0,0,0
MANIPUR,2009,Bus (Private),21,8,29
MANIPUR,2009,Tempo/Vans (Government),0,0,0
MANIPUR,2009,Tempo/Vans (Private),3,0,3
MANIPUR,2009,Jeep (Government),0,0,0
MANIPUR,2009,Jeep (Private),3,0,3
MANIPUR,2009,Car (Government),3,0,3
MANIPUR,2009,Car (Private),1,2,3
MANIPUR,2009,Three Wheeler,3,2,5
MANIPUR,2009,Two Wheeler,14,5,19
MANIPUR,2009,Bicycle,1,1,2
MANIPUR,2009,Pedestrian,2,2,4
MANIPUR,2009,Others (Please Specify),3,1,4
MANIPUR,2009,Total Deaths (Persons),95,30,125
MANIPUR,2009,Total Truck/Lorry,41,9,50
MANIPUR,2009,Total Bus,21,8,29
MANIPUR,2009,Total Tempo/Vans,3,0,3
MANIPUR,2009,Total Jeep,3,0,3
MANIPUR,2009,Total Car,4,2,6
MANIPUR,2010,Truck/Lorry (Government),14,0,14
MANIPUR,2010,Truck/Lorry (Private),34,11,45
MANIPUR,2010,Bus (Government),2,0,2
MANIPUR,2010,Bus (Private),9,1,10
MANIPUR,2010,Tempo/Vans (Government),0,0,0
MANIPUR,2010,Tempo/Vans (Private),8,0,8
MANIPUR,2010,Jeep (Government),1,0,1
MANIPUR,2010,Jeep (Private),4,1,5
MANIPUR,2010,Car (Government),0,0,0
MANIPUR,2010,Car (Private),5,2,7
MANIPUR,2010,Three Wheeler,4,1,5
MANIPUR,2010,Two Wheeler,25,10,35
MANIPUR,2010,Bicycle,1,0,1
MANIPUR,2010,Pedestrian,0,0,0
MANIPUR,2010,Others (Please Specify),13,7,20
MANIPUR,2010,Total Deaths (Persons),120,33,153
MANIPUR,2010,Total Truck/Lorry,48,11,59
MANIPUR,2010,Total Bus,11,1,12
MANIPUR,2010,Total Tempo/Vans,8,0,8
MANIPUR,2010,Total Jeep,5,1,6
MANIPUR,2010,Total Car,5,2,7
MANIPUR,2011,Truck/Lorry (Government),3,1,4
MANIPUR,2011,Truck/Lorry (Private),29,3,32
MANIPUR,2011,Bus (Government),0,0,0
MANIPUR,2011,Bus (Private),9,0,9
MANIPUR,2011,Tempo/Vans (Government),0,0,0
MANIPUR,2011,Tempo/Vans (Private),5,1,6
MANIPUR,2011,Jeep (Government),0,0,0
MANIPUR,2011,Jeep (Private),9,1,10
MANIPUR,2011,Car (Government),0,0,0
MANIPUR,2011,Car (Private),11,0,11
MANIPUR,2011,Three Wheeler,6,1,7
MANIPUR,2011,Two Wheeler,33,3,36
MANIPUR,2011,Bicycle,5,0,5
MANIPUR,2011,Pedestrian,17,7,24
MANIPUR,2011,Others (Please Specify),10,2,12
MANIPUR,2011,Total Deaths (Persons),137,19,156
MANIPUR,2011,Total Truck/Lorry,32,4,36
MANIPUR,2011,Total Bus,9,0,9
MANIPUR,2011,Total Tempo/Vans,5,1,6
MANIPUR,2011,Total Jeep,9,1,10
MANIPUR,2011,Total Car,11,0,11
MANIPUR,2012,Truck/Lorry (Government),2,0,2
MANIPUR,2012,Truck/Lorry (Private),35,3,38
MANIPUR,2012,Bus (Government),0,0,0
MANIPUR,2012,Bus (Private),10,7,17
MANIPUR,2012,Tempo/Vans (Government),0,0,0
MANIPUR,2012,Tempo/Vans (Private),5,2,7
MANIPUR,2012,Jeep (Government),0,0,0
MANIPUR,2012,Jeep (Private),4,2,6
MANIPUR,2012,Car (Government),0,0,0
MANIPUR,2012,Car (Private),6,0,6
MANIPUR,2012,Three Wheeler,4,0,4
MANIPUR,2012,Two Wheeler,39,4,43
MANIPUR,2012,Bicycle,1,0,1
MANIPUR,2012,Pedestrian,16,7,23
MANIPUR,2012,Others (Please Specify),8,3,11
MANIPUR,2012,Total Deaths (Persons),130,28,158
MANIPUR,2012,Total Truck/Lorry,37,3,40
MANIPUR,2012,Total Bus,10,7,17
MANIPUR,2012,Total Tempo/Vans,5,2,7
MANIPUR,2012,Total Jeep,4,2,6
MANIPUR,2012,Total Car,6,0,6
MEGHALAYA,2001,Truck/Lorry (Government),4,0,4
MEGHALAYA,2001,Truck/Lorry (Private),52,3,55
MEGHALAYA,2001,Bus (Government),0,0,0
MEGHALAYA,2001,Bus (Private),32,1,33
MEGHALAYA,2001,Tempo/Vans (Government),0,0,0
MEGHALAYA,2001,Tempo/Vans (Private),4,0,4
MEGHALAYA,2001,Jeep (Government),1,0,1
MEGHALAYA,2001,Jeep (Private),5,0,5
MEGHALAYA,2001,Car (Government),0,0,0
MEGHALAYA,2001,Car (Private),9,2,11
MEGHALAYA,2001,Three Wheeler,3,1,4
MEGHALAYA,2001,Two Wheeler,7,2,9
MEGHALAYA,2001,Bicycle,1,0,1
MEGHALAYA,2001,Pedestrian,2,4,6
MEGHALAYA,2001,Others (Please Specify),5,0,5
MEGHALAYA,2001,Total Deaths (Persons),125,13,138
MEGHALAYA,2001,Total Truck/Lorry,56,3,59
MEGHALAYA,2001,Total Bus,32,1,33
MEGHALAYA,2001,Total Tempo/Vans,4,0,4
MEGHALAYA,2001,Total Jeep,6,0,6
MEGHALAYA,2001,Total Car,9,2,11
MEGHALAYA,2002,Truck/Lorry (Government),20,0,20
MEGHALAYA,2002,Truck/Lorry (Private),32,0,32
MEGHALAYA,2002,Bus (Government),3,0,3
MEGHALAYA,2002,Bus (Private),11,3,14
MEGHALAYA,2002,Tempo/Vans (Government),0,0,0
MEGHALAYA,2002,Tempo/Vans (Private),2,2,4
MEGHALAYA,2002,Jeep (Government),0,0,0
MEGHALAYA,2002,Jeep (Private),8,0,8
MEGHALAYA,2002,Car (Government),0,0,0
MEGHALAYA,2002,Car (Private),8,1,9
MEGHALAYA,2002,Three Wheeler,2,0,2
MEGHALAYA,2002,Two Wheeler,9,2,11
MEGHALAYA,2002,Bicycle,0,0,0
MEGHALAYA,2002,Pedestrian,13,4,17
MEGHALAYA,2002,Others (Please Specify),5,0,5
MEGHALAYA,2002,Total Deaths (Persons),113,12,125
MEGHALAYA,2002,Total Truck/Lorry,52,0,52
MEGHALAYA,2002,Total Bus,14,3,17
MEGHALAYA,2002,Total Tempo/Vans,2,2,4
MEGHALAYA,2002,Total Jeep,8,0,8
MEGHALAYA,2002,Total Car,8,1,9
MEGHALAYA,2003,Truck/Lorry (Government),0,0,0
MEGHALAYA,2003,Truck/Lorry (Private),36,3,39
MEGHALAYA,2003,Bus (Government),0,0,0
MEGHALAYA,2003,Bus (Private),35,4,39
MEGHALAYA,2003,Tempo/Vans (Government),0,0,0
MEGHALAYA,2003,Tempo/Vans (Private),3,0,3
MEGHALAYA,2003,Jeep (Government),0,0,0
MEGHALAYA,2003,Jeep (Private),6,2,8
MEGHALAYA,2003,Car (Government),0,0,0
MEGHALAYA,2003,Car (Private),8,2,10
MEGHALAYA,2003,Three Wheeler,1,0,1
MEGHALAYA,2003,Two Wheeler,1,0,1
MEGHALAYA,2003,Bicycle,0,0,0
MEGHALAYA,2003,Pedestrian,6,5,11
MEGHALAYA,2003,Others (Please Specify),6,0,6
MEGHALAYA,2003,Total Deaths (Persons),102,16,118
MEGHALAYA,2003,Total Truck/Lorry,36,3,39
MEGHALAYA,2003,Total Bus,35,4,39
MEGHALAYA,2003,Total Tempo/Vans,3,0,3
MEGHALAYA,2003,Total Jeep,6,2,8
MEGHALAYA,2003,Total Car,8,2,10
MEGHALAYA,2004,Truck/Lorry (Government),2,0,2
MEGHALAYA,2004,Truck/Lorry (Private),29,1,30
MEGHALAYA,2004,Bus (Government),2,0,2
MEGHALAYA,2004,Bus (Private),20,3,23
MEGHALAYA,2004,Tempo/Vans (Government),0,0,0
MEGHALAYA,2004,Tempo/Vans (Private),7,3,10
MEGHALAYA,2004,Jeep (Government),0,0,0
MEGHALAYA,2004,Jeep (Private),7,2,9
MEGHALAYA,2004,Car (Government),0,0,0
MEGHALAYA,2004,Car (Private),8,4,12
MEGHALAYA,2004,Three Wheeler,4,3,7
MEGHALAYA,2004,Two Wheeler,8,0,8
MEGHALAYA,2004,Bicycle,0,0,0
MEGHALAYA,2004,Pedestrian,16,2,18
MEGHALAYA,2004,Others (Please Specify),4,3,7
MEGHALAYA,2004,Total Deaths (Persons),107,21,128
MEGHALAYA,2004,Total Truck/Lorry,31,1,32
MEGHALAYA,2004,Total Bus,22,3,25
MEGHALAYA,2004,Total Tempo/Vans,7,3,10
MEGHALAYA,2004,Total Jeep,7,2,9
MEGHALAYA,2004,Total Car,8,4,12
MEGHALAYA,2005,Truck/Lorry (Government),0,0,0
MEGHALAYA,2005,Truck/Lorry (Private),31,6,37
MEGHALAYA,2005,Bus (Government),0,0,0
MEGHALAYA,2005,Bus (Private),29,4,33
MEGHALAYA,2005,Tempo/Vans (Government),0,0,0
MEGHALAYA,2005,Tempo/Vans (Private),3,0,3
MEGHALAYA,2005,Jeep (Government),0,0,0
MEGHALAYA,2005,Jeep (Private),4,2,6
MEGHALAYA,2005,Car (Government),0,0,0
MEGHALAYA,2005,Car (Private),12,6,18
MEGHALAYA,2005,Three Wheeler,6,3,9
MEGHALAYA,2005,Two Wheeler,3,1,4
MEGHALAYA,2005,Bicycle,2,0,2
MEGHALAYA,2005,Pedestrian,5,3,8
MEGHALAYA,2005,Others (Please Specify),2,0,2
MEGHALAYA,2005,Total Deaths (Persons),97,25,122
MEGHALAYA,2005,Total Truck/Lorry,31,6,37
MEGHALAYA,2005,Total Bus,29,4,33
MEGHALAYA,2005,Total Tempo/Vans,3,0,3
MEGHALAYA,2005,Total Jeep,4,2,6
MEGHALAYA,2005,Total Car,12,6,18
MEGHALAYA,2006,Truck/Lorry (Government),0,0,0
MEGHALAYA,2006,Truck/Lorry (Private),32,5,37
MEGHALAYA,2006,Bus (Government),0,0,0
MEGHALAYA,2006,Bus (Private),18,4,22
MEGHALAYA,2006,Tempo/Vans (Government),0,0,0
MEGHALAYA,2006,Tempo/Vans (Private),9,4,13
MEGHALAYA,2006,Jeep (Government),1,0,1
MEGHALAYA,2006,Jeep (Private),5,2,7
MEGHALAYA,2006,Car (Government),0,0,0
MEGHALAYA,2006,Car (Private),5,4,9
MEGHALAYA,2006,Three Wheeler,2,0,2
MEGHALAYA,2006,Two Wheeler,3,0,3
MEGHALAYA,2006,Bicycle,2,0,2
MEGHALAYA,2006,Pedestrian,15,5,20
MEGHALAYA,2006,Others (Please Specify),14,2,16
MEGHALAYA,2006,Total Deaths (Persons),106,26,132
MEGHALAYA,2006,Total Truck/Lorry,32,5,37
MEGHALAYA,2006,Total Bus,18,4,22
MEGHALAYA,2006,Total Tempo/Vans,9,4,13
MEGHALAYA,2006,Total Jeep,6,2,8
MEGHALAYA,2006,Total Car,5,4,9
MEGHALAYA,2007,Truck/Lorry (Government),0,0,0
MEGHALAYA,2007,Truck/Lorry (Private),23,1,24
MEGHALAYA,2007,Bus (Government),0,0,0
MEGHALAYA,2007,Bus (Private),25,6,31
MEGHALAYA,2007,Tempo/Vans (Government),0,0,0
MEGHALAYA,2007,Tempo/Vans (Private),5,0,5
MEGHALAYA,2007,Jeep (Government),0,0,0
MEGHALAYA,2007,Jeep (Private),14,3,17
MEGHALAYA,2007,Car (Government),0,0,0
MEGHALAYA,2007,Car (Private),6,2,8
MEGHALAYA,2007,Three Wheeler,1,0,1
MEGHALAYA,2007,Two Wheeler,5,0,5
MEGHALAYA,2007,Bicycle,2,0,2
MEGHALAYA,2007,Pedestrian,17,2,19
MEGHALAYA,2007,Others (Please Specify),11,10,21
MEGHALAYA,2007,Total Deaths (Persons),109,24,133
MEGHALAYA,2007,Total Truck/Lorry,23,1,24
MEGHALAYA,2007,Total Bus,25,6,31
MEGHALAYA,2007,Total Tempo/Vans,5,0,5
MEGHALAYA,2007,Total Jeep,14,3,17
MEGHALAYA,2007,Total Car,6,2,8
MEGHALAYA,2008,Truck/Lorry (Government),0,0,0
MEGHALAYA,2008,Truck/Lorry (Private),47,7,54
MEGHALAYA,2008,Bus (Government),0,0,0
MEGHALAYA,2008,Bus (Private),26,9,35
MEGHALAYA,2008,Tempo/Vans (Government),0,0,0
MEGHALAYA,2008,Tempo/Vans (Private),7,1,8
MEGHALAYA,2008,Jeep (Government),0,0,0
MEGHALAYA,2008,Jeep (Private),4,0,4
MEGHALAYA,2008,Car (Government),0,0,0
MEGHALAYA,2008,Car (Private),17,10,27
MEGHALAYA,2008,Three Wheeler,7,0,7
MEGHALAYA,2008,Two Wheeler,3,0,3
MEGHALAYA,2008,Bicycle,1,0,1
MEGHALAYA,2008,Pedestrian,4,2,6
MEGHALAYA,2008,Others (Please Specify),4,0,4
MEGHALAYA,2008,Total Deaths (Persons),120,29,149
MEGHALAYA,2008,Total Truck/Lorry,47,7,54
MEGHALAYA,2008,Total Bus,26,9,35
MEGHALAYA,2008,Total Tempo/Vans,7,1,8
MEGHALAYA,2008,Total Jeep,4,0,4
MEGHALAYA,2008,Total Car,17,10,27
MEGHALAYA,2009,Truck/Lorry (Government),0,0,0
MEGHALAYA,2009,Truck/Lorry (Private),45,6,51
MEGHALAYA,2009,Bus (Government),0,0,0
MEGHALAYA,2009,Bus (Private),41,4,45
MEGHALAYA,2009,Tempo/Vans (Government),0,0,0
MEGHALAYA,2009,Tempo/Vans (Private),14,0,14
MEGHALAYA,2009,Jeep (Government),0,0,0
MEGHALAYA,2009,Jeep (Private),8,1,9
MEGHALAYA,2009,Car (Government),0,0,0
MEGHALAYA,2009,Car (Private),29,1,30
MEGHALAYA,2009,Three Wheeler,2,0,2
MEGHALAYA,2009,Two Wheeler,6,0,6
MEGHALAYA,2009,Bicycle,2,0,2
MEGHALAYA,2009,Pedestrian,13,4,17
MEGHALAYA,2009,Others (Please Specify),15,2,17
MEGHALAYA,2009,Total Deaths (Persons),175,18,193
MEGHALAYA,2009,Total Truck/Lorry,45,6,51
MEGHALAYA,2009,Total Bus,41,4,45
MEGHALAYA,2009,Total Tempo/Vans,14,0,14
MEGHALAYA,2009,Total Jeep,8,1,9
MEGHALAYA,2009,Total Car,29,1,30
MEGHALAYA,2010,Truck/Lorry (Government),13,3,16
MEGHALAYA,2010,Truck/Lorry (Private),55,3,58
MEGHALAYA,2010,Bus (Government),4,1,5
MEGHALAYA,2010,Bus (Private),10,1,11
MEGHALAYA,2010,Tempo/Vans (Government),2,1,3
MEGHALAYA,2010,Tempo/Vans (Private),13,2,15
MEGHALAYA,2010,Jeep (Government),0,0,0
MEGHALAYA,2010,Jeep (Private),8,6,14
MEGHALAYA,2010,Car (Government),0,0,0
MEGHALAYA,2010,Car (Private),15,3,18
MEGHALAYA,2010,Three Wheeler,5,0,5
MEGHALAYA,2010,Two Wheeler,11,1,12
MEGHALAYA,2010,Bicycle,1,0,1
MEGHALAYA,2010,Pedestrian,13,4,17
MEGHALAYA,2010,Others (Please Specify),8,1,9
MEGHALAYA,2010,Total Deaths (Persons),158,26,184
MEGHALAYA,2010,Total Truck/Lorry,68,6,74
MEGHALAYA,2010,Total Bus,14,2,16
MEGHALAYA,2010,Total Tempo/Vans,15,3,18
MEGHALAYA,2010,Total Jeep,8,6,14
MEGHALAYA,2010,Total Car,15,3,18
MEGHALAYA,2011,Truck/Lorry (Government),4,0,4
MEGHALAYA,2011,Truck/Lorry (Private),93,1,94
MEGHALAYA,2011,Bus (Government),1,1,2
MEGHALAYA,2011,Bus (Private),13,5,18
MEGHALAYA,2011,Tempo/Vans (Government),2,0,2
MEGHALAYA,2011,Tempo/Vans (Private),13,1,14
MEGHALAYA,2011,Jeep (Government),2,0,2
MEGHALAYA,2011,Jeep (Private),4,0,4
MEGHALAYA,2011,Car (Government),2,0,2
MEGHALAYA,2011,Car (Private),22,4,26
MEGHALAYA,2011,Three Wheeler,3,4,7
MEGHALAYA,2011,Two Wheeler,20,2,22
MEGHALAYA,2011,Bicycle,0,0,0
MEGHALAYA,2011,Pedestrian,15,4,19
MEGHALAYA,2011,Others (Please Specify),8,5,13
MEGHALAYA,2011,Total Deaths (Persons),202,27,229
MEGHALAYA,2011,Total Truck/Lorry,97,1,98
MEGHALAYA,2011,Total Bus,14,6,20
MEGHALAYA,2011,Total Tempo/Vans,15,1,16
MEGHALAYA,2011,Total Jeep,6,0,6
MEGHALAYA,2011,Total Car,24,4,28
MEGHALAYA,2012,Truck/Lorry (Government),0,0,0
MEGHALAYA,2012,Truck/Lorry (Private),62,9,71
MEGHALAYA,2012,Bus (Government),0,0,0
MEGHALAYA,2012,Bus (Private),48,2,50
MEGHALAYA,2012,Tempo/Vans (Government),1,0,1
MEGHALAYA,2012,Tempo/Vans (Private),5,2,7
MEGHALAYA,2012,Jeep (Government),10,0,10
MEGHALAYA,2012,Jeep (Private),3,0,3
MEGHALAYA,2012,Car (Government),7,3,10
MEGHALAYA,2012,Car (Private),7,1,8
MEGHALAYA,2012,Three Wheeler,10,4,14
MEGHALAYA,2012,Two Wheeler,22,3,25
MEGHALAYA,2012,Bicycle,0,0,0
MEGHALAYA,2012,Pedestrian,0,1,1
MEGHALAYA,2012,Others (Please Specify),11,2,13
MEGHALAYA,2012,Total Deaths (Persons),186,27,213
MEGHALAYA,2012,Total Truck/Lorry,62,9,71
MEGHALAYA,2012,Total Bus,48,2,50
MEGHALAYA,2012,Total Tempo/Vans,6,2,8
MEGHALAYA,2012,Total Jeep,13,0,13
MEGHALAYA,2012,Total Car,14,4,18
MIZORAM,2001,Truck/Lorry (Government),1,0,1
MIZORAM,2001,Truck/Lorry (Private),19,5,24
MIZORAM,2001,Bus (Government),0,0,0
MIZORAM,2001,Bus (Private),20,8,28
MIZORAM,2001,Tempo/Vans (Government),0,0,0
MIZORAM,2001,Tempo/Vans (Private),7,1,8
MIZORAM,2001,Jeep (Government),0,0,0
MIZORAM,2001,Jeep (Private),3,2,5
MIZORAM,2001,Car (Government),0,0,0
MIZORAM,2001,Car (Private),0,0,0
MIZORAM,2001,Three Wheeler,0,0,0
MIZORAM,2001,Two Wheeler,1,0,1
MIZORAM,2001,Bicycle,0,0,0
MIZORAM,2001,Pedestrian,0,0,0
MIZORAM,2001,Others (Please Specify),0,0,0
MIZORAM,2001,Total Deaths (Persons),51,16,67
MIZORAM,2001,Total Truck/Lorry,20,5,25
MIZORAM,2001,Total Bus,20,8,28
MIZORAM,2001,Total Tempo/Vans,7,1,8
MIZORAM,2001,Total Jeep,3,2,5
MIZORAM,2001,Total Car,0,0,0
MIZORAM,2002,Truck/Lorry (Government),1,0,1
MIZORAM,2002,Truck/Lorry (Private),16,2,18
MIZORAM,2002,Bus (Government),0,0,0
MIZORAM,2002,Bus (Private),4,1,5
MIZORAM,2002,Tempo/Vans (Government),0,0,0
MIZORAM,2002,Tempo/Vans (Private),0,0,0
MIZORAM,2002,Jeep (Government),0,0,0
MIZORAM,2002,Jeep (Private),5,3,8
MIZORAM,2002,Car (Government),0,0,0
MIZORAM,2002,Car (Private),1,0,1
MIZORAM,2002,Three Wheeler,3,2,5
MIZORAM,2002,Two Wheeler,3,0,3
MIZORAM,2002,Bicycle,0,0,0
MIZORAM,2002,Pedestrian,1,0,1
MIZORAM,2002,Others (Please Specify),7,1,8
MIZORAM,2002,Total Deaths (Persons),41,9,50
MIZORAM,2002,Total Truck/Lorry,17,2,19
MIZORAM,2002,Total Bus,4,1,5
MIZORAM,2002,Total Tempo/Vans,0,0,0
MIZORAM,2002,Total Jeep,5,3,8
MIZORAM,2002,Total Car,1,0,1
MIZORAM,2003,Truck/Lorry (Government),0,0,0
MIZORAM,2003,Truck/Lorry (Private),36,7,43
MIZORAM,2003,Bus (Government),3,0,3
MIZORAM,2003,Bus (Private),3,0,3
MIZORAM,2003,Tempo/Vans (Government),1,0,1
MIZORAM,2003,Tempo/Vans (Private),1,0,1
MIZORAM,2003,Jeep (Government),0,0,0
MIZORAM,2003,Jeep (Private),5,0,5
MIZORAM,2003,Car (Government),0,0,0
MIZORAM,2003,Car (Private),6,4,10
MIZORAM,2003,Three Wheeler,4,0,4
MIZORAM,2003,Two Wheeler,4,1,5
MIZORAM,2003,Bicycle,0,0,0
MIZORAM,2003,Pedestrian,0,0,0
MIZORAM,2003,Others (Please Specify),0,1,1
MIZORAM,2003,Total Deaths (Persons),63,13,76
MIZORAM,2003,Total Truck/Lorry,36,7,43
MIZORAM,2003,Total Bus,6,0,6
MIZORAM,2003,Total Tempo/Vans,2,0,2
MIZORAM,2003,Total Jeep,5,0,5
MIZORAM,2003,Total Car,6,4,10
MIZORAM,2004,Truck/Lorry (Government),3,0,3
MIZORAM,2004,Truck/Lorry (Private),14,5,19
MIZORAM,2004,Bus (Government),0,0,0
MIZORAM,2004,Bus (Private),5,3,8
MIZORAM,2004,Tempo/Vans (Government),0,0,0
MIZORAM,2004,Tempo/Vans (Private),0,0,0
MIZORAM,2004,Jeep (Government),0,0,0
MIZORAM,2004,Jeep (Private),4,4,8
MIZORAM,2004,Car (Government),0,0,0
MIZORAM,2004,Car (Private),3,3,6
MIZORAM,2004,Three Wheeler,4,2,6
MIZORAM,2004,Two Wheeler,4,2,6
MIZORAM,2004,Bicycle,0,0,0
MIZORAM,2004,Pedestrian,0,0,0
MIZORAM,2004,Others (Please Specify),9,2,11
MIZORAM,2004,Total Deaths (Persons),46,21,67
MIZORAM,2004,Total Truck/Lorry,17,5,22
MIZORAM,2004,Total Bus,5,3,8
MIZORAM,2004,Total Tempo/Vans,0,0,0
MIZORAM,2004,Total Jeep,4,4,8
MIZORAM,2004,Total Car,3,3,6
MIZORAM,2005,Truck/Lorry (Government),0,0,0
MIZORAM,2005,Truck/Lorry (Private),15,6,21
MIZORAM,2005,Bus (Government),0,0,0
MIZORAM,2005,Bus (Private),2,1,3
MIZORAM,2005,Tempo/Vans (Government),0,0,0
MIZORAM,2005,Tempo/Vans (Private),3,1,4
MIZORAM,2005,Jeep (Government),1,0,1
MIZORAM,2005,Jeep (Private),6,3,9
MIZORAM,2005,Car (Government),0,0,0
MIZORAM,2005,Car (Private),1,0,1
MIZORAM,2005,Three Wheeler,0,0,0
MIZORAM,2005,Two Wheeler,7,2,9
MIZORAM,2005,Bicycle,0,0,0
MIZORAM,2005,Pedestrian,0,0,0
MIZORAM,2005,Others (Please Specify),4,0,4
MIZORAM,2005,Total Deaths (Persons),39,13,52
MIZORAM,2005,Total Truck/Lorry,15,6,21
MIZORAM,2005,Total Bus,2,1,3
MIZORAM,2005,Total Tempo/Vans,3,1,4
MIZORAM,2005,Total Jeep,7,3,10
MIZORAM,2005,Total Car,1,0,1
MIZORAM,2006,Truck/Lorry (Government),0,0,0
MIZORAM,2006,Truck/Lorry (Private),18,1,19
MIZORAM,2006,Bus (Government),0,0,0
MIZORAM,2006,Bus (Private),10,3,13
MIZORAM,2006,Tempo/Vans (Government),0,0,0
MIZORAM,2006,Tempo/Vans (Private),4,1,5
MIZORAM,2006,Jeep (Government),0,0,0
MIZORAM,2006,Jeep (Private),7,1,8
MIZORAM,2006,Car (Government),0,0,0
MIZORAM,2006,Car (Private),1,1,2
MIZORAM,2006,Three Wheeler,0,0,0
MIZORAM,2006,Two Wheeler,8,1,9
MIZORAM,2006,Bicycle,0,0,0
MIZORAM,2006,Pedestrian,0,0,0
MIZORAM,2006,Others (Please Specify),8,0,8
MIZORAM,2006,Total Deaths (Persons),56,8,64
MIZORAM,2006,Total Truck/Lorry,18,1,19
MIZORAM,2006,Total Bus,10,3,13
MIZORAM,2006,Total Tempo/Vans,4,1,5
MIZORAM,2006,Total Jeep,7,1,8
MIZORAM,2006,Total Car,1,1,2
MIZORAM,2007,Truck/Lorry (Government),0,0,0
MIZORAM,2007,Truck/Lorry (Private),9,1,10
MIZORAM,2007,Bus (Government),0,0,0
MIZORAM,2007,Bus (Private),2,2,4
MIZORAM,2007,Tempo/Vans (Government),0,0,0
MIZORAM,2007,Tempo/Vans (Private),0,0,0
MIZORAM,2007,Jeep (Government),0,0,0
MIZORAM,2007,Jeep (Private),10,3,13
MIZORAM,2007,Car (Government),0,0,0
MIZORAM,2007,Car (Private),2,0,2
MIZORAM,2007,Three Wheeler,0,0,0
MIZORAM,2007,Two Wheeler,5,0,5
MIZORAM,2007,Bicycle,0,0,0
MIZORAM,2007,Pedestrian,0,0,0
MIZORAM,2007,Others (Please Specify),0,1,1
MIZORAM,2007,Total Deaths (Persons),28,7,35
MIZORAM,2007,Total Truck/Lorry,9,1,10
MIZORAM,2007,Total Bus,2,2,4
MIZORAM,2007,Total Tempo/Vans,0,0,0
MIZORAM,2007,Total Jeep,10,3,13
MIZORAM,2007,Total Car,2,0,2
MIZORAM,2008,Truck/Lorry (Government),0,0,0
MIZORAM,2008,Truck/Lorry (Private),27,2,29
MIZORAM,2008,Bus (Government),0,0,0
MIZORAM,2008,Bus (Private),4,0,4
MIZORAM,2008,Tempo/Vans (Government),0,0,0
MIZORAM,2008,Tempo/Vans (Private),1,1,2
MIZORAM,2008,Jeep (Government),0,0,0
MIZORAM,2008,Jeep (Private),4,0,4
MIZORAM,2008,Car (Government),0,0,0
MIZORAM,2008,Car (Private),3,1,4
MIZORAM,2008,Three Wheeler,1,0,1
MIZORAM,2008,Two Wheeler,7,1,8
MIZORAM,2008,Bicycle,0,0,0
MIZORAM,2008,Pedestrian,0,0,0
MIZORAM,2008,Others (Please Specify),23,3,26
MIZORAM,2008,Total Deaths (Persons),70,8,78
MIZORAM,2008,Total Truck/Lorry,27,2,29
MIZORAM,2008,Total Bus,4,0,4
MIZORAM,2008,Total Tempo/Vans,1,1,2
MIZORAM,2008,Total Jeep,4,0,4
MIZORAM,2008,Total Car,3,1,4
MIZORAM,2009,Truck/Lorry (Government),0,0,0
MIZORAM,2009,Truck/Lorry (Private),21,1,22
MIZORAM,2009,Bus (Government),1,0,1
MIZORAM,2009,Bus (Private),6,2,8
MIZORAM,2009,Tempo/Vans (Government),2,0,2
MIZORAM,2009,Tempo/Vans (Private),0,0,0
MIZORAM,2009,Jeep (Government),3,0,3
MIZORAM,2009,Jeep (Private),1,1,2
MIZORAM,2009,Car (Government),5,0,5
MIZORAM,2009,Car (Private),5,0,5
MIZORAM,2009,Three Wheeler,0,1,1
MIZORAM,2009,Two Wheeler,2,2,4
MIZORAM,2009,Bicycle,0,0,0
MIZORAM,2009,Pedestrian,0,0,0
MIZORAM,2009,Others (Please Specify),8,2,10
MIZORAM,2009,Total Deaths (Persons),54,9,63
MIZORAM,2009,Total Truck/Lorry,21,1,22
MIZORAM,2009,Total Bus,7,2,9
MIZORAM,2009,Total Tempo/Vans,2,0,2
MIZORAM,2009,Total Jeep,4,1,5
MIZORAM,2009,Total Car,10,0,10
MIZORAM,2010,Truck/Lorry (Government),0,0,0
MIZORAM,2010,Truck/Lorry (Private),18,4,22
MIZORAM,2010,Bus (Government),22,1,23
MIZORAM,2010,Bus (Private),0,0,0
MIZORAM,2010,Tempo/Vans (Government),0,0,0
MIZORAM,2010,Tempo/Vans (Private),0,2,2
MIZORAM,2010,Jeep (Government),0,0,0
MIZORAM,2010,Jeep (Private),4,1,5
MIZORAM,2010,Car (Government),1,3,4
MIZORAM,2010,Car (Private),0,0,0
MIZORAM,2010,Three Wheeler,0,0,0
MIZORAM,2010,Two Wheeler,10,4,14
MIZORAM,2010,Bicycle,0,0,0
MIZORAM,2010,Pedestrian,0,0,0
MIZORAM,2010,Others (Please Specify),9,3,12
MIZORAM,2010,Total Deaths (Persons),64,18,82
MIZORAM,2010,Total Truck/Lorry,18,4,22
MIZORAM,2010,Total Bus,22,1,23
MIZORAM,2010,Total Tempo/Vans,0,2,2
MIZORAM,2010,Total Jeep,4,1,5
MIZORAM,2010,Total Car,1,3,4
MIZORAM,2011,Truck/Lorry (Government),0,0,0
MIZORAM,2011,Truck/Lorry (Private),24,6,30
MIZORAM,2011,Bus (Government),0,0,0
MIZORAM,2011,Bus (Private),12,9,21
MIZORAM,2011,Tempo/Vans (Government),0,0,0
MIZORAM,2011,Tempo/Vans (Private),0,0,0
MIZORAM,2011,Jeep (Government),0,0,0
MIZORAM,2011,Jeep (Private),2,0,2
MIZORAM,2011,Car (Government),0,0,0
MIZORAM,2011,Car (Private),5,3,8
MIZORAM,2011,Three Wheeler,0,0,0
MIZORAM,2011,Two Wheeler,10,2,12
MIZORAM,2011,Bicycle,1,1,2
MIZORAM,2011,Pedestrian,0,1,1
MIZORAM,2011,Others (Please Specify),5,0,5
MIZORAM,2011,Total Deaths (Persons),59,22,81
MIZORAM,2011,Total Truck/Lorry,24,6,30
MIZORAM,2011,Total Bus,12,9,21
MIZORAM,2011,Total Tempo/Vans,0,0,0
MIZORAM,2011,Total Jeep,2,0,2
MIZORAM,2011,Total Car,5,3,8
MIZORAM,2012,Truck/Lorry (Government),0,0,0
MIZORAM,2012,Truck/Lorry (Private),17,1,18
MIZORAM,2012,Bus (Government),0,0,0
MIZORAM,2012,Bus (Private),4,0,4
MIZORAM,2012,Tempo/Vans (Government),0,0,0
MIZORAM,2012,Tempo/Vans (Private),6,0,6
MIZORAM,2012,Jeep (Government),0,0,0
MIZORAM,2012,Jeep (Private),9,0,9
MIZORAM,2012,Car (Government),0,0,0
MIZORAM,2012,Car (Private),4,6,10
MIZORAM,2012,Three Wheeler,2,0,2
MIZORAM,2012,Two Wheeler,17,7,24
MIZORAM,2012,Bicycle,0,0,0
MIZORAM,2012,Pedestrian,2,1,3
MIZORAM,2012,Others (Please Specify),1,0,1
MIZORAM,2012,Total Deaths (Persons),62,15,77
MIZORAM,2012,Total Truck/Lorry,17,1,18
MIZORAM,2012,Total Bus,4,0,4
MIZORAM,2012,Total Tempo/Vans,6,0,6
MIZORAM,2012,Total Jeep,9,0,9
MIZORAM,2012,Total Car,4,6,10
NAGALAND,2001,Truck/Lorry (Government),10,0,10
NAGALAND,2001,Truck/Lorry (Private),22,2,24
NAGALAND,2001,Bus (Government),1,0,1
NAGALAND,2001,Bus (Private),13,1,14
NAGALAND,2001,Tempo/Vans (Government),1,0,1
NAGALAND,2001,Tempo/Vans (Private),2,1,3
NAGALAND,2001,Jeep (Government),1,0,1
NAGALAND,2001,Jeep (Private),0,0,0
NAGALAND,2001,Car (Government),1,0,1
NAGALAND,2001,Car (Private),5,1,6
NAGALAND,2001,Three Wheeler,0,0,0
NAGALAND,2001,Two Wheeler,3,0,3
NAGALAND,2001,Bicycle,0,0,0
NAGALAND,2001,Pedestrian,0,0,0
NAGALAND,2001,Others (Please Specify),1,0,1
NAGALAND,2001,Total Deaths (Persons),60,5,65
NAGALAND,2001,Total Truck/Lorry,32,2,34
NAGALAND,2001,Total Bus,14,1,15
NAGALAND,2001,Total Tempo/Vans,3,1,4
NAGALAND,2001,Total Jeep,1,0,1
NAGALAND,2001,Total Car,6,1,7
NAGALAND,2002,Truck/Lorry (Government),2,0,2
NAGALAND,2002,Truck/Lorry (Private),11,1,12
NAGALAND,2002,Bus (Government),0,0,0
NAGALAND,2002,Bus (Private),7,2,9
NAGALAND,2002,Tempo/Vans (Government),0,0,0
NAGALAND,2002,Tempo/Vans (Private),5,0,5
NAGALAND,2002,Jeep (Government),0,0,0
NAGALAND,2002,Jeep (Private),2,0,2
NAGALAND,2002,Car (Government),0,0,0
NAGALAND,2002,Car (Private),6,0,6
NAGALAND,2002,Three Wheeler,0,0,0
NAGALAND,2002,Two Wheeler,0,0,0
NAGALAND,2002,Bicycle,1,0,1
NAGALAND,2002,Pedestrian,1,0,1
NAGALAND,2002,Others (Please Specify),0,0,0
NAGALAND,2002,Total Deaths (Persons),35,3,38
NAGALAND,2002,Total Truck/Lorry,13,1,14
NAGALAND,2002,Total Bus,7,2,9
NAGALAND,2002,Total Tempo/Vans,5,0,5
NAGALAND,2002,Total Jeep,2,0,2
NAGALAND,2002,Total Car,6,0,6
NAGALAND,2003,Truck/Lorry (Government),2,0,2
NAGALAND,2003,Truck/Lorry (Private),27,1,28
NAGALAND,2003,Bus (Government),0,0,0
NAGALAND,2003,Bus (Private),7,4,11
NAGALAND,2003,Tempo/Vans (Government),1,1,2
NAGALAND,2003,Tempo/Vans (Private),3,2,5
NAGALAND,2003,Jeep (Government),0,0,0
NAGALAND,2003,Jeep (Private),3,1,4
NAGALAND,2003,Car (Government),0,0,0
NAGALAND,2003,Car (Private),4,0,4
NAGALAND,2003,Three Wheeler,0,1,1
NAGALAND,2003,Two Wheeler,5,0,5
NAGALAND,2003,Bicycle,0,0,0
NAGALAND,2003,Pedestrian,3,0,3
NAGALAND,2003,Others (Please Specify),0,0,0
NAGALAND,2003,Total Deaths (Persons),55,10,65
NAGALAND,2003,Total Truck/Lorry,29,1,30
NAGALAND,2003,Total Bus,7,4,11
NAGALAND,2003,Total Tempo/Vans,4,3,7
NAGALAND,2003,Total Jeep,3,1,4
NAGALAND,2003,Total Car,4,0,4
NAGALAND,2004,Truck/Lorry (Government),1,0,1
NAGALAND,2004,Truck/Lorry (Private),9,0,9
NAGALAND,2004,Bus (Government),16,1,17
NAGALAND,2004,Bus (Private),4,0,4
NAGALAND,2004,Tempo/Vans (Government),0,0,0
NAGALAND,2004,Tempo/Vans (Private),8,3,11
NAGALAND,2004,Jeep (Government),1,0,1
NAGALAND,2004,Jeep (Private),3,0,3
NAGALAND,2004,Car (Government),0,0,0
NAGALAND,2004,Car (Private),3,0,3
NAGALAND,2004,Three Wheeler,3,3,6
NAGALAND,2004,Two Wheeler,2,0,2
NAGALAND,2004,Bicycle,0,0,0
NAGALAND,2004,Pedestrian,2,1,3
NAGALAND,2004,Others (Please Specify),3,0,3
NAGALAND,2004,Total Deaths (Persons),55,8,63
NAGALAND,2004,Total Truck/Lorry,10,0,10
NAGALAND,2004,Total Bus,20,1,21
NAGALAND,2004,Total Tempo/Vans,8,3,11
NAGALAND,2004,Total Jeep,4,0,4
NAGALAND,2004,Total Car,3,0,3
NAGALAND,2005,Truck/Lorry (Government),1,0,1
NAGALAND,2005,Truck/Lorry (Private),16,1,17
NAGALAND,2005,Bus (Government),0,0,0
NAGALAND,2005,Bus (Private),5,0,5
NAGALAND,2005,Tempo/Vans (Government),0,0,0
NAGALAND,2005,Tempo/Vans (Private),5,0,5
NAGALAND,2005,Jeep (Government),1,0,1
NAGALAND,2005,Jeep (Private),4,0,4
NAGALAND,2005,Car (Government),0,0,0
NAGALAND,2005,Car (Private),1,1,2
NAGALAND,2005,Three Wheeler,1,1,2
NAGALAND,2005,Two Wheeler,3,0,3
NAGALAND,2005,Bicycle,0,0,0
NAGALAND,2005,Pedestrian,0,0,0
NAGALAND,2005,Others (Please Specify),2,0,2
NAGALAND,2005,Total Deaths (Persons),39,3,42
NAGALAND,2005,Total Truck/Lorry,17,1,18
NAGALAND,2005,Total Bus,5,0,5
NAGALAND,2005,Total Tempo/Vans,5,0,5
NAGALAND,2005,Total Jeep,5,0,5
NAGALAND,2005,Total Car,1,1,2
NAGALAND,2006,Truck/Lorry (Government),7,0,7
NAGALAND,2006,Truck/Lorry (Private),10,1,11
NAGALAND,2006,Bus (Government),0,0,0
NAGALAND,2006,Bus (Private),12,1,13
NAGALAND,2006,Tempo/Vans (Government),0,0,0
NAGALAND,2006,Tempo/Vans (Private),3,0,3
NAGALAND,2006,Jeep (Government),0,0,0
NAGALAND,2006,Jeep (Private),5,0,5
NAGALAND,2006,Car (Government),0,0,0
NAGALAND,2006,Car (Private),2,3,5
NAGALAND,2006,Three Wheeler,3,0,3
NAGALAND,2006,Two Wheeler,7,0,7
NAGALAND,2006,Bicycle,1,0,1
NAGALAND,2006,Pedestrian,5,0,5
NAGALAND,2006,Others (Please Specify),2,0,2
NAGALAND,2006,Total Deaths (Persons),57,5,62
NAGALAND,2006,Total Truck/Lorry,17,1,18
NAGALAND,2006,Total Bus,12,1,13
NAGALAND,2006,Total Tempo/Vans,3,0,3
NAGALAND,2006,Total Jeep,5,0,5
NAGALAND,2006,Total Car,2,3,5
NAGALAND,2007,Truck/Lorry (Government),1,0,1
NAGALAND,2007,Truck/Lorry (Private),7,2,9
NAGALAND,2007,Bus (Government),9,2,11
NAGALAND,2007,Bus (Private),22,5,27
NAGALAND,2007,Tempo/Vans (Government),0,0,0
NAGALAND,2007,Tempo/Vans (Private),3,0,3
NAGALAND,2007,Jeep (Government),0,0,0
NAGALAND,2007,Jeep (Private),4,0,4
NAGALAND,2007,Car (Government),0,0,0
NAGALAND,2007,Car (Private),7,1,8
NAGALAND,2007,Three Wheeler,2,2,4
NAGALAND,2007,Two Wheeler,6,1,7
NAGALAND,2007,Bicycle,1,0,1
NAGALAND,2007,Pedestrian,10,2,12
NAGALAND,2007,Others (Please Specify),3,2,5
NAGALAND,2007,Total Deaths (Persons),75,17,92
NAGALAND,2007,Total Truck/Lorry,8,2,10
NAGALAND,2007,Total Bus,31,7,38
NAGALAND,2007,Total Tempo/Vans,3,0,3
NAGALAND,2007,Total Jeep,4,0,4
NAGALAND,2007,Total Car,7,1,8
NAGALAND,2008,Truck/Lorry (Government),5,0,5
NAGALAND,2008,Truck/Lorry (Private),23,0,23
NAGALAND,2008,Bus (Government),16,4,20
NAGALAND,2008,Bus (Private),4,0,4
NAGALAND,2008,Tempo/Vans (Government),6,0,6
NAGALAND,2008,Tempo/Vans (Private),6,0,6
NAGALAND,2008,Jeep (Government),0,0,0
NAGALAND,2008,Jeep (Private),4,0,4
NAGALAND,2008,Car (Government),0,0,0
NAGALAND,2008,Car (Private),10,0,10
NAGALAND,2008,Three Wheeler,4,2,6
NAGALAND,2008,Two Wheeler,14,0,14
NAGALAND,2008,Bicycle,4,0,4
NAGALAND,2008,Pedestrian,8,4,12
NAGALAND,2008,Others (Please Specify),2,0,2
NAGALAND,2008,Total Deaths (Persons),106,10,116
NAGALAND,2008,Total Truck/Lorry,28,0,28
NAGALAND,2008,Total Bus,20,4,24
NAGALAND,2008,Total Tempo/Vans,12,0,12
NAGALAND,2008,Total Jeep,4,0,4
NAGALAND,2008,Total Car,10,0,10
NAGALAND,2009,Truck/Lorry (Government),8,0,8
NAGALAND,2009,Truck/Lorry (Private),13,0,13
NAGALAND,2009,Bus (Government),0,0,0
NAGALAND,2009,Bus (Private),9,1,10
NAGALAND,2009,Tempo/Vans (Government),0,0,0
NAGALAND,2009,Tempo/Vans (Private),1,0,1
NAGALAND,2009,Jeep (Government),0,0,0
NAGALAND,2009,Jeep (Private),1,0,1
NAGALAND,2009,Car (Government),0,0,0
NAGALAND,2009,Car (Private),4,1,5
NAGALAND,2009,Three Wheeler,1,1,2
NAGALAND,2009,Two Wheeler,3,0,3
NAGALAND,2009,Bicycle,2,0,2
NAGALAND,2009,Pedestrian,2,1,3
NAGALAND,2009,Others (Please Specify),2,0,2
NAGALAND,2009,Total Deaths (Persons),46,4,50
NAGALAND,2009,Total Truck/Lorry,21,0,21
NAGALAND,2009,Total Bus,9,1,10
NAGALAND,2009,Total Tempo/Vans,1,0,1
NAGALAND,2009,Total Jeep,1,0,1
NAGALAND,2009,Total Car,4,1,5
NAGALAND,2010,Truck/Lorry (Government),0,0,0
NAGALAND,2010,Truck/Lorry (Private),11,2,13
NAGALAND,2010,Bus (Government),1,3,4
NAGALAND,2010,Bus (Private),2,2,4
NAGALAND,2010,Tempo/Vans (Government),0,0,0
NAGALAND,2010,Tempo/Vans (Private),3,1,4
NAGALAND,2010,Jeep (Government),0,0,0
NAGALAND,2010,Jeep (Private),6,0,6
NAGALAND,2010,Car (Government),0,0,0
NAGALAND,2010,Car (Private),3,0,3
NAGALAND,2010,Three Wheeler,2,0,2
NAGALAND,2010,Two Wheeler,1,0,1
NAGALAND,2010,Bicycle,1,0,1
NAGALAND,2010,Pedestrian,4,1,5
NAGALAND,2010,Others (Please Specify),1,0,1
NAGALAND,2010,Total Deaths (Persons),35,9,44
NAGALAND,2010,Total Truck/Lorry,11,2,13
NAGALAND,2010,Total Bus,3,5,8
NAGALAND,2010,Total Tempo/Vans,3,1,4
NAGALAND,2010,Total Jeep,6,0,6
NAGALAND,2010,Total Car,3,0,3
NAGALAND,2011,Truck/Lorry (Government),0,0,0
NAGALAND,2011,Truck/Lorry (Private),11,2,13
NAGALAND,2011,Bus (Government),0,0,0
NAGALAND,2011,Bus (Private),4,0,4
NAGALAND,2011,Tempo/Vans (Government),0,0,0
NAGALAND,2011,Tempo/Vans (Private),0,0,0
NAGALAND,2011,Jeep (Government),0,0,0
NAGALAND,2011,Jeep (Private),7,0,7
NAGALAND,2011,Car (Government),0,0,0
NAGALAND,2011,Car (Private),6,2,8
NAGALAND,2011,Three Wheeler,0,0,0
NAGALAND,2011,Two Wheeler,1,0,1
NAGALAND,2011,Bicycle,0,0,0
NAGALAND,2011,Pedestrian,0,0,0
NAGALAND,2011,Others (Please Specify),3,0,3
NAGALAND,2011,Total Deaths (Persons),32,4,36
NAGALAND,2011,Total Truck/Lorry,11,2,13
NAGALAND,2011,Total Bus,4,0,4
NAGALAND,2011,Total Tempo/Vans,0,0,0
NAGALAND,2011,Total Jeep,7,0,7
NAGALAND,2011,Total Car,6,2,8
NAGALAND,2012,Truck/Lorry (Government),0,0,0
NAGALAND,2012,Truck/Lorry (Private),20,1,21
NAGALAND,2012,Bus (Government),0,0,0
NAGALAND,2012,Bus (Private),7,3,10
NAGALAND,2012,Tempo/Vans (Government),0,0,0
NAGALAND,2012,Tempo/Vans (Private),2,0,2
NAGALAND,2012,Jeep (Government),1,0,1
NAGALAND,2012,Jeep (Private),1,0,1
NAGALAND,2012,Car (Government),0,0,0
NAGALAND,2012,Car (Private),2,0,2
NAGALAND,2012,Three Wheeler,4,1,5
NAGALAND,2012,Two Wheeler,4,1,5
NAGALAND,2012,Bicycle,2,0,2
NAGALAND,2012,Pedestrian,5,1,6
NAGALAND,2012,Others (Please Specify),1,0,1
NAGALAND,2012,Total Deaths (Persons),49,7,56
NAGALAND,2012,Total Truck/Lorry,20,1,21
NAGALAND,2012,Total Bus,7,3,10
NAGALAND,2012,Total Tempo/Vans,2,0,2
NAGALAND,2012,Total Jeep,2,0,2
NAGALAND,2012,Total Car,2,0,2
ODISHA,2001,Truck/Lorry (Government),10,3,13
ODISHA,2001,Truck/Lorry (Private),530,100,630
ODISHA,2001,Bus (Government),13,7,20
ODISHA,2001,Bus (Private),191,67,258
ODISHA,2001,Tempo/Vans (Government),6,1,7
ODISHA,2001,Tempo/Vans (Private),49,10,59
ODISHA,2001,Jeep (Government),14,0,14
ODISHA,2001,Jeep (Private),144,34,178
ODISHA,2001,Car (Government),0,0,0
ODISHA,2001,Car (Private),115,29,144
ODISHA,2001,Three Wheeler,31,12,43
ODISHA,2001,Two Wheeler,249,45,294
ODISHA,2001,Bicycle,27,12,39
ODISHA,2001,Pedestrian,48,9,57
ODISHA,2001,Others (Please Specify),138,46,184
ODISHA,2001,Total Deaths (Persons),1565,375,1940
ODISHA,2001,Total Truck/Lorry,540,103,643
ODISHA,2001,Total Bus,204,74,278
ODISHA,2001,Total Tempo/Vans,55,11,66
ODISHA,2001,Total Jeep,158,34,192
ODISHA,2001,Total Car,115,29,144
ODISHA,2002,Truck/Lorry (Government),0,2,2
ODISHA,2002,Truck/Lorry (Private),587,85,672
ODISHA,2002,Bus (Government),6,1,7
ODISHA,2002,Bus (Private),242,48,290
ODISHA,2002,Tempo/Vans (Government),3,0,3
ODISHA,2002,Tempo/Vans (Private),56,8,64
ODISHA,2002,Jeep (Government),6,0,6
ODISHA,2002,Jeep (Private),140,18,158
ODISHA,2002,Car (Government),3,0,3
ODISHA,2002,Car (Private),102,33,135
ODISHA,2002,Three Wheeler,32,0,32
ODISHA,2002,Two Wheeler,328,44,372
ODISHA,2002,Bicycle,44,6,50
ODISHA,2002,Pedestrian,61,15,76
ODISHA,2002,Others (Please Specify),215,40,255
ODISHA,2002,Total Deaths (Persons),1825,300,2125
ODISHA,2002,Total Truck/Lorry,587,87,674
ODISHA,2002,Total Bus,248,49,297
ODISHA,2002,Total Tempo/Vans,59,8,67
ODISHA,2002,Total Jeep,146,18,164
ODISHA,2002,Total Car,105,33,138
ODISHA,2003,Truck/Lorry (Government),39,20,59
ODISHA,2003,Truck/Lorry (Private),640,101,741
ODISHA,2003,Bus (Government),3,1,4
ODISHA,2003,Bus (Private),195,51,246
ODISHA,2003,Tempo/Vans (Government),2,0,2
ODISHA,2003,Tempo/Vans (Private),33,7,40
ODISHA,2003,Jeep (Government),3,2,5
ODISHA,2003,Jeep (Private),195,32,227
ODISHA,2003,Car (Government),0,0,0
ODISHA,2003,Car (Private),105,19,124
ODISHA,2003,Three Wheeler,49,11,60
ODISHA,2003,Two Wheeler,304,63,367
ODISHA,2003,Bicycle,35,5,40
ODISHA,2003,Pedestrian,65,15,80
ODISHA,2003,Others (Please Specify),273,53,326
ODISHA,2003,Total Deaths (Persons),1941,380,2321
ODISHA,2003,Total Truck/Lorry,679,121,800
ODISHA,2003,Total Bus,198,52,250
ODISHA,2003,Total Tempo/Vans,35,7,42
ODISHA,2003,Total Jeep,198,34,232
ODISHA,2003,Total Car,105,19,124
ODISHA,2004,Truck/Lorry (Government),29,2,31
ODISHA,2004,Truck/Lorry (Private),755,133,888
ODISHA,2004,Bus (Government),2,0,2
ODISHA,2004,Bus (Private),225,67,292
ODISHA,2004,Tempo/Vans (Government),5,0,5
ODISHA,2004,Tempo/Vans (Private),61,16,77
ODISHA,2004,Jeep (Government),3,0,3
ODISHA,2004,Jeep (Private),166,48,214
ODISHA,2004,Car (Government),0,0,0
ODISHA,2004,Car (Private),121,38,159
ODISHA,2004,Three Wheeler,61,15,76
ODISHA,2004,Two Wheeler,313,66,379
ODISHA,2004,Bicycle,32,5,37
ODISHA,2004,Pedestrian,73,11,84
ODISHA,2004,Others (Please Specify),187,38,225
ODISHA,2004,Total Deaths (Persons),2033,439,2472
ODISHA,2004,Total Truck/Lorry,784,135,919
ODISHA,2004,Total Bus,227,67,294
ODISHA,2004,Total Tempo/Vans,66,16,82
ODISHA,2004,Total Jeep,169,48,217
ODISHA,2004,Total Car,121,38,159
ODISHA,2005,Truck/Lorry (Government),1,0,1
ODISHA,2005,Truck/Lorry (Private),784,272,1056
ODISHA,2005,Bus (Government),3,0,3
ODISHA,2005,Bus (Private),208,69,277
ODISHA,2005,Tempo/Vans (Government),11,0,11
ODISHA,2005,Tempo/Vans (Private),100,28,128
ODISHA,2005,Jeep (Government),10,1,11
ODISHA,2005,Jeep (Private),140,33,173
ODISHA,2005,Car (Government),2,0,2
ODISHA,2005,Car (Private),215,61,276
ODISHA,2005,Three Wheeler,43,8,51
ODISHA,2005,Two Wheeler,428,76,504
ODISHA,2005,Bicycle,36,3,39
ODISHA,2005,Pedestrian,52,5,57
ODISHA,2005,Others (Please Specify),261,45,306
ODISHA,2005,Total Deaths (Persons),2294,601,2895
ODISHA,2005,Total Truck/Lorry,785,272,1057
ODISHA,2005,Total Bus,211,69,280
ODISHA,2005,Total Tempo/Vans,111,28,139
ODISHA,2005,Total Jeep,150,34,184
ODISHA,2005,Total Car,217,61,278
ODISHA,2006,Truck/Lorry (Government),24,0,24
ODISHA,2006,Truck/Lorry (Private),786,139,925
ODISHA,2006,Bus (Government),1,1,2
ODISHA,2006,Bus (Private),259,103,362
ODISHA,2006,Tempo/Vans (Government),1,5,6
ODISHA,2006,Tempo/Vans (Private),114,25,139
ODISHA,2006,Jeep (Government),1,0,1
ODISHA,2006,Jeep (Private),152,32,184
ODISHA,2006,Car (Government),0,0,0
ODISHA,2006,Car (Private),209,44,253
ODISHA,2006,Three Wheeler,43,14,57
ODISHA,2006,Two Wheeler,414,71,485
ODISHA,2006,Bicycle,19,2,21
ODISHA,2006,Pedestrian,37,6,43
ODISHA,2006,Others (Please Specify),199,44,243
ODISHA,2006,Total Deaths (Persons),2259,486,2745
ODISHA,2006,Total Truck/Lorry,810,139,949
ODISHA,2006,Total Bus,260,104,364
ODISHA,2006,Total Tempo/Vans,115,30,145
ODISHA,2006,Total Jeep,153,32,185
ODISHA,2006,Total Car,209,44,253
ODISHA,2007,Truck/Lorry (Government),5,3,8
ODISHA,2007,Truck/Lorry (Private),982,144,1126
ODISHA,2007,Bus (Government),4,0,4
ODISHA,2007,Bus (Private),225,68,293
ODISHA,2007,Tempo/Vans (Government),5,0,5
ODISHA,2007,Tempo/Vans (Private),92,28,120
ODISHA,2007,Jeep (Government),4,0,4
ODISHA,2007,Jeep (Private),127,32,159
ODISHA,2007,Car (Government),0,1,1
ODISHA,2007,Car (Private),217,61,278
ODISHA,2007,Three Wheeler,38,8,46
ODISHA,2007,Two Wheeler,520,119,639
ODISHA,2007,Bicycle,25,4,29
ODISHA,2007,Pedestrian,58,16,74
ODISHA,2007,Others (Please Specify),216,56,272
ODISHA,2007,Total Deaths (Persons),2518,540,3058
ODISHA,2007,Total Truck/Lorry,987,147,1134
ODISHA,2007,Total Bus,229,68,297
ODISHA,2007,Total Tempo/Vans,97,28,125
ODISHA,2007,Total Jeep,131,32,163
ODISHA,2007,Total Car,217,62,279
ODISHA,2008,Truck/Lorry (Government),2,0,2
ODISHA,2008,Truck/Lorry (Private),943,106,1049
ODISHA,2008,Bus (Government),8,3,11
ODISHA,2008,Bus (Private),260,70,330
ODISHA,2008,Tempo/Vans (Government),0,0,0
ODISHA,2008,Tempo/Vans (Private),117,27,144
ODISHA,2008,Jeep (Government),4,1,5
ODISHA,2008,Jeep (Private),148,16,164
ODISHA,2008,Car (Government),1,1,2
ODISHA,2008,Car (Private),200,39,239
ODISHA,2008,Three Wheeler,66,15,81
ODISHA,2008,Two Wheeler,423,92,515
ODISHA,2008,Bicycle,41,6,47
ODISHA,2008,Pedestrian,97,33,130
ODISHA,2008,Others (Please Specify),350,35,385
ODISHA,2008,Total Deaths (Persons),2660,444,3104
ODISHA,2008,Total Truck/Lorry,945,106,1051
ODISHA,2008,Total Bus,268,73,341
ODISHA,2008,Total Tempo/Vans,117,27,144
ODISHA,2008,Total Jeep,152,17,169
ODISHA,2008,Total Car,201,40,241
ODISHA,2009,Truck/Lorry (Government),4,2,6
ODISHA,2009,Truck/Lorry (Private),942,95,1037
ODISHA,2009,Bus (Government),4,2,6
ODISHA,2009,Bus (Private),323,72,395
ODISHA,2009,Tempo/Vans (Government),0,1,1
ODISHA,2009,Tempo/Vans (Private),150,23,173
ODISHA,2009,Jeep (Government),7,1,8
ODISHA,2009,Jeep (Private),176,27,203
ODISHA,2009,Car (Government),0,0,0
ODISHA,2009,Car (Private),175,45,220
ODISHA,2009,Three Wheeler,79,15,94
ODISHA,2009,Two Wheeler,613,102,715
ODISHA,2009,Bicycle,44,5,49
ODISHA,2009,Pedestrian,113,34,147
ODISHA,2009,Others (Please Specify),408,87,495
ODISHA,2009,Total Deaths (Persons),3038,511,3549
ODISHA,2009,Total Truck/Lorry,946,97,1043
ODISHA,2009,Total Bus,327,74,401
ODISHA,2009,Total Tempo/Vans,150,24,174
ODISHA,2009,Total Jeep,183,28,211
ODISHA,2009,Total Car,175,45,220
ODISHA,2010,Truck/Lorry (Government),48,14,62
ODISHA,2010,Truck/Lorry (Private),1275,179,1454
ODISHA,2010,Bus (Government),7,1,8
ODISHA,2010,Bus (Private),251,73,324
ODISHA,2010,Tempo/Vans (Government),2,0,2
ODISHA,2010,Tempo/Vans (Private),136,39,175
ODISHA,2010,Jeep (Government),1,0,1
ODISHA,2010,Jeep (Private),163,37,200
ODISHA,2010,Car (Government),1,0,1
ODISHA,2010,Car (Private),262,62,324
ODISHA,2010,Three Wheeler,93,35,128
ODISHA,2010,Two Wheeler,596,110,706
ODISHA,2010,Bicycle,45,4,49
ODISHA,2010,Pedestrian,100,17,117
ODISHA,2010,Others (Please Specify),480,74,554
ODISHA,2010,Total Deaths (Persons),3460,645,4105
ODISHA,2010,Total Truck/Lorry,1323,193,1516
ODISHA,2010,Total Bus,258,74,332
ODISHA,2010,Total Tempo/Vans,138,39,177
ODISHA,2010,Total Jeep,164,37,201
ODISHA,2010,Total Car,263,62,325
ODISHA,2011,Truck/Lorry (Government),1,0,1
ODISHA,2011,Truck/Lorry (Private),1074,86,1160
ODISHA,2011,Bus (Government),11,2,13
ODISHA,2011,Bus (Private),334,92,426
ODISHA,2011,Tempo/Vans (Government),7,0,7
ODISHA,2011,Tempo/Vans (Private),205,65,270
ODISHA,2011,Jeep (Government),3,0,3
ODISHA,2011,Jeep (Private),164,37,201
ODISHA,2011,Car (Government),6,3,9
ODISHA,2011,Car (Private),249,70,319
ODISHA,2011,Three Wheeler,83,26,109
ODISHA,2011,Two Wheeler,482,105,587
ODISHA,2011,Bicycle,31,3,34
ODISHA,2011,Pedestrian,66,16,82
ODISHA,2011,Others (Please Specify),482,94,576
ODISHA,2011,Total Deaths (Persons),3198,599,3797
ODISHA,2011,Total Truck/Lorry,1075,86,1161
ODISHA,2011,Total Bus,345,94,439
ODISHA,2011,Total Tempo/Vans,212,65,277
ODISHA,2011,Total Jeep,167,37,204
ODISHA,2011,Total Car,255,73,328
ODISHA,2012,Truck/Lorry (Government),9,6,15
ODISHA,2012,Truck/Lorry (Private),1004,86,1090
ODISHA,2012,Bus (Government),1,0,1
ODISHA,2012,Bus (Private),241,71,312
ODISHA,2012,Tempo/Vans (Government),9,0,9
ODISHA,2012,Tempo/Vans (Private),201,37,238
ODISHA,2012,Jeep (Government),0,0,0
ODISHA,2012,Jeep (Private),114,30,144
ODISHA,2012,Car (Government),1,1,2
ODISHA,2012,Car (Private),284,60,344
ODISHA,2012,Three Wheeler,138,25,163
ODISHA,2012,Two Wheeler,685,119,804
ODISHA,2012,Bicycle,56,8,64
ODISHA,2012,Pedestrian,95,24,119
ODISHA,2012,Others (Please Specify),323,73,396
ODISHA,2012,Total Deaths (Persons),3161,540,3701
ODISHA,2012,Total Truck/Lorry,1013,92,1105
ODISHA,2012,Total Bus,242,71,313
ODISHA,2012,Total Tempo/Vans,210,37,247
ODISHA,2012,Total Jeep,114,30,144
ODISHA,2012,Total Car,285,61,346
PUNJAB,2001,Truck/Lorry (Government),10,0,10
PUNJAB,2001,Truck/Lorry (Private),276,33,309
PUNJAB,2001,Bus (Government),83,19,102
PUNJAB,2001,Bus (Private),137,19,156
PUNJAB,2001,Tempo/Vans (Government),1,0,1
PUNJAB,2001,Tempo/Vans (Private),119,19,138
PUNJAB,2001,Jeep (Government),22,4,26
PUNJAB,2001,Jeep (Private),72,19,91
PUNJAB,2001,Car (Government),13,3,16
PUNJAB,2001,Car (Private),127,23,150
PUNJAB,2001,Three Wheeler,40,11,51
PUNJAB,2001,Two Wheeler,218,19,237
PUNJAB,2001,Bicycle,55,7,62
PUNJAB,2001,Pedestrian,62,8,70
PUNJAB,2001,Others (Please Specify),65,25,90
PUNJAB,2001,Total Deaths (Persons),1300,209,1509
PUNJAB,2001,Total Truck/Lorry,286,33,319
PUNJAB,2001,Total Bus,220,38,258
PUNJAB,2001,Total Tempo/Vans,120,19,139
PUNJAB,2001,Total Jeep,94,23,117
PUNJAB,2001,Total Car,140,26,166
PUNJAB,2002,Truck/Lorry (Government),6,0,6
PUNJAB,2002,Truck/Lorry (Private),295,23,318
PUNJAB,2002,Bus (Government),73,9,82
PUNJAB,2002,Bus (Private),135,28,163
PUNJAB,2002,Tempo/Vans (Government),0,0,0
PUNJAB,2002,Tempo/Vans (Private),133,14,147
PUNJAB,2002,Jeep (Government),4,3,7
PUNJAB,2002,Jeep (Private),99,15,114
PUNJAB,2002,Car (Government),191,36,227
PUNJAB,2002,Car (Private),7,1,8
PUNJAB,2002,Three Wheeler,118,22,140
PUNJAB,2002,Two Wheeler,3,0,3
PUNJAB,2002,Bicycle,221,18,239
PUNJAB,2002,Pedestrian,68,3,71
PUNJAB,2002,Others (Please Specify),82,1,83
PUNJAB,2002,Total Deaths (Persons),1435,173,1608
PUNJAB,2002,Total Truck/Lorry,301,23,324
PUNJAB,2002,Total Bus,208,37,245
PUNJAB,2002,Total Tempo/Vans,133,14,147
PUNJAB,2002,Total Jeep,103,18,121
PUNJAB,2002,Total Car,198,37,235
PUNJAB,2003,Truck/Lorry (Government),17,0,17
PUNJAB,2003,Truck/Lorry (Private),362,14,376
PUNJAB,2003,Bus (Government),49,11,60
PUNJAB,2003,Bus (Private),132,22,154
PUNJAB,2003,Tempo/Vans (Government),1,0,1
PUNJAB,2003,Tempo/Vans (Private),113,12,125
PUNJAB,2003,Jeep (Government),0,0,0
PUNJAB,2003,Jeep (Private),84,14,98
PUNJAB,2003,Car (Government),13,1,14
PUNJAB,2003,Car (Private),183,24,207
PUNJAB,2003,Three Wheeler,40,17,57
PUNJAB,2003,Two Wheeler,245,25,270
PUNJAB,2003,Bicycle,54,1,55
PUNJAB,2003,Pedestrian,39,1,40
PUNJAB,2003,Others (Please Specify),73,10,83
PUNJAB,2003,Total Deaths (Persons),1405,152,1557
PUNJAB,2003,Total Truck/Lorry,379,14,393
PUNJAB,2003,Total Bus,181,33,214
PUNJAB,2003,Total Tempo/Vans,114,12,126
PUNJAB,2003,Total Jeep,84,14,98
PUNJAB,2003,Total Car,196,25,221
PUNJAB,2004,Truck/Lorry (Government),31,2,33
PUNJAB,2004,Truck/Lorry (Private),305,17,322
PUNJAB,2004,Bus (Government),61,10,71
PUNJAB,2004,Bus (Private),142,15,157
PUNJAB,2004,Tempo/Vans (Government),6,0,6
PUNJAB,2004,Tempo/Vans (Private),143,9,152
PUNJAB,2004,Jeep (Government),0,0,0
PUNJAB,2004,Jeep (Private),80,8,88
PUNJAB,2004,Car (Government),23,2,25
PUNJAB,2004,Car (Private),218,22,240
PUNJAB,2004,Three Wheeler,30,9,39
PUNJAB,2004,Two Wheeler,334,73,407
PUNJAB,2004,Bicycle,87,7,94
PUNJAB,2004,Pedestrian,66,5,71
PUNJAB,2004,Others (Please Specify),130,20,150
PUNJAB,2004,Total Deaths (Persons),1656,199,1855
PUNJAB,2004,Total Truck/Lorry,336,19,355
PUNJAB,2004,Total Bus,203,25,228
PUNJAB,2004,Total Tempo/Vans,149,9,158
PUNJAB,2004,Total Jeep,80,8,88
PUNJAB,2004,Total Car,241,24,265
PUNJAB,2005,Truck/Lorry (Government),33,3,36
PUNJAB,2005,Truck/Lorry (Private),256,29,285
PUNJAB,2005,Bus (Government),57,11,68
PUNJAB,2005,Bus (Private),114,33,147
PUNJAB,2005,Tempo/Vans (Government),0,0,0
PUNJAB,2005,Tempo/Vans (Private),140,16,156
PUNJAB,2005,Jeep (Government),1,0,1
PUNJAB,2005,Jeep (Private),69,14,83
PUNJAB,2005,Car (Government),4,2,6
PUNJAB,2005,Car (Private),240,40,280
PUNJAB,2005,Three Wheeler,46,7,53
PUNJAB,2005,Two Wheeler,0,0,0
PUNJAB,2005,Bicycle,377,37,414
PUNJAB,2005,Pedestrian,0,0,0
PUNJAB,2005,Others (Please Specify),83,10,93
PUNJAB,2005,Total Deaths (Persons),1420,202,1622
PUNJAB,2005,Total Truck/Lorry,289,32,321
PUNJAB,2005,Total Bus,171,44,215
PUNJAB,2005,Total Tempo/Vans,140,16,156
PUNJAB,2005,Total Jeep,70,14,84
PUNJAB,2005,Total Car,244,42,286
PUNJAB,2006,Truck/Lorry (Government),3,0,3
PUNJAB,2006,Truck/Lorry (Private),328,49,377
PUNJAB,2006,Bus (Government),37,8,45
PUNJAB,2006,Bus (Private),115,40,155
PUNJAB,2006,Tempo/Vans (Government),0,0,0
PUNJAB,2006,Tempo/Vans (Private),103,9,112
PUNJAB,2006,Jeep (Government),3,2,5
PUNJAB,2006,Jeep (Private),85,11,96
PUNJAB,2006,Car (Government),5,0,5
PUNJAB,2006,Car (Private),253,53,306
PUNJAB,2006,Three Wheeler,47,5,52
PUNJAB,2006,Two Wheeler,415,58,473
PUNJAB,2006,Bicycle,76,5,81
PUNJAB,2006,Pedestrian,64,12,76
PUNJAB,2006,Others (Please Specify),232,30,262
PUNJAB,2006,Total Deaths (Persons),1766,282,2048
PUNJAB,2006,Total Truck/Lorry,331,49,380
PUNJAB,2006,Total Bus,152,48,200
PUNJAB,2006,Total Tempo/Vans,103,9,112
PUNJAB,2006,Total Jeep,88,13,101
PUNJAB,2006,Total Car,258,53,311
PUNJAB,2007,Truck/Lorry (Government),1,0,1
PUNJAB,2007,Truck/Lorry (Private),348,17,365
PUNJAB,2007,Bus (Government),54,14,68
PUNJAB,2007,Bus (Private),151,19,170
PUNJAB,2007,Tempo/Vans (Government),5,0,5
PUNJAB,2007,Tempo/Vans (Private),118,13,131
PUNJAB,2007,Jeep (Government),3,0,3
PUNJAB,2007,Jeep (Private),90,13,103
PUNJAB,2007,Car (Government),0,0,0
PUNJAB,2007,Car (Private),298,49,347
PUNJAB,2007,Three Wheeler,32,11,43
PUNJAB,2007,Two Wheeler,422,61,483
PUNJAB,2007,Bicycle,89,4,93
PUNJAB,2007,Pedestrian,95,18,113
PUNJAB,2007,Others (Please Specify),213,17,230
PUNJAB,2007,Total Deaths (Persons),1919,236,2155
PUNJAB,2007,Total Truck/Lorry,349,17,366
PUNJAB,2007,Total Bus,205,33,238
PUNJAB,2007,Total Tempo/Vans,123,13,136
PUNJAB,2007,Total Jeep,93,13,106
PUNJAB,2007,Total Car,298,49,347
PUNJAB,2008,Truck/Lorry (Government),7,1,8
PUNJAB,2008,Truck/Lorry (Private),293,36,329
PUNJAB,2008,Bus (Government),27,6,33
PUNJAB,2008,Bus (Private),161,16,177
PUNJAB,2008,Tempo/Vans (Government),0,0,0
PUNJAB,2008,Tempo/Vans (Private),83,7,90
PUNJAB,2008,Jeep (Government),1,0,1
PUNJAB,2008,Jeep (Private),81,10,91
PUNJAB,2008,Car (Government),8,0,8
PUNJAB,2008,Car (Private),248,37,285
PUNJAB,2008,Three Wheeler,48,7,55
PUNJAB,2008,Two Wheeler,436,51,487
PUNJAB,2008,Bicycle,77,9,86
PUNJAB,2008,Pedestrian,116,15,131
PUNJAB,2008,Others (Please Specify),243,31,274
PUNJAB,2008,Total Deaths (Persons),1829,226,2055
PUNJAB,2008,Total Truck/Lorry,300,37,337
PUNJAB,2008,Total Bus,188,22,210
PUNJAB,2008,Total Tempo/Vans,83,7,90
PUNJAB,2008,Total Jeep,82,10,92
PUNJAB,2008,Total Car,256,37,293
PUNJAB,2009,Truck/Lorry (Government),3,0,3
PUNJAB,2009,Truck/Lorry (Private),349,36,385
PUNJAB,2009,Bus (Government),37,9,46
PUNJAB,2009,Bus (Private),156,15,171
PUNJAB,2009,Tempo/Vans (Government),1,0,1
PUNJAB,2009,Tempo/Vans (Private),110,11,121
PUNJAB,2009,Jeep (Government),3,2,5
PUNJAB,2009,Jeep (Private),113,11,124
PUNJAB,2009,Car (Government),0,2,2
PUNJAB,2009,Car (Private),348,49,397
PUNJAB,2009,Three Wheeler,39,6,45
PUNJAB,2009,Two Wheeler,542,65,607
PUNJAB,2009,Bicycle,85,0,85
PUNJAB,2009,Pedestrian,139,17,156
PUNJAB,2009,Others (Please Specify),225,19,244
PUNJAB,2009,Total Deaths (Persons),2150,242,2392
PUNJAB,2009,Total Truck/Lorry,352,36,388
PUNJAB,2009,Total Bus,193,24,217
PUNJAB,2009,Total Tempo/Vans,111,11,122
PUNJAB,2009,Total Jeep,116,13,129
PUNJAB,2009,Total Car,348,51,399
PUNJAB,2010,Truck/Lorry (Government),2,1,3
PUNJAB,2010,Truck/Lorry (Private),231,38,269
PUNJAB,2010,Bus (Government),24,2,26
PUNJAB,2010,Bus (Private),134,36,170
PUNJAB,2010,Tempo/Vans (Government),7,1,8
PUNJAB,2010,Tempo/Vans (Private),121,20,141
PUNJAB,2010,Jeep (Government),1,0,1
PUNJAB,2010,Jeep (Private),89,12,101
PUNJAB,2010,Car (Government),2,0,2
PUNJAB,2010,Car (Private),324,44,368
PUNJAB,2010,Three Wheeler,58,5,63
PUNJAB,2010,Two Wheeler,448,52,500
PUNJAB,2010,Bicycle,68,1,69
PUNJAB,2010,Pedestrian,73,5,78
PUNJAB,2010,Others (Please Specify),299,35,334
PUNJAB,2010,Total Deaths (Persons),1881,252,2133
PUNJAB,2010,Total Truck/Lorry,233,39,272
PUNJAB,2010,Total Bus,158,38,196
PUNJAB,2010,Total Tempo/Vans,128,21,149
PUNJAB,2010,Total Jeep,90,12,102
PUNJAB,2010,Total Car,326,44,370
PUNJAB,2011,Truck/Lorry (Government),12,8,20
PUNJAB,2011,Truck/Lorry (Private),743,75,818
PUNJAB,2011,Bus (Government),89,16,105
PUNJAB,2011,Bus (Private),270,66,336
PUNJAB,2011,Tempo/Vans (Government),2,1,3
PUNJAB,2011,Tempo/Vans (Private),259,37,296
PUNJAB,2011,Jeep (Government),8,0,8
PUNJAB,2011,Jeep (Private),265,45,310
PUNJAB,2011,Car (Government),13,5,18
PUNJAB,2011,Car (Private),672,127,799
PUNJAB,2011,Three Wheeler,58,12,70
PUNJAB,2011,Two Wheeler,1044,132,1176
PUNJAB,2011,Bicycle,146,8,154
PUNJAB,2011,Pedestrian,218,24,242
PUNJAB,2011,Others (Please Specify),485,57,542
PUNJAB,2011,Total Deaths (Persons),4284,613,4897
PUNJAB,2011,Total Truck/Lorry,755,83,838
PUNJAB,2011,Total Bus,359,82,441
PUNJAB,2011,Total Tempo/Vans,261,38,299
PUNJAB,2011,Total Jeep,273,45,318
PUNJAB,2011,Total Car,685,132,817
PUNJAB,2012,Truck/Lorry (Government),19,10,29
PUNJAB,2012,Truck/Lorry (Private),643,126,769
PUNJAB,2012,Bus (Government),91,34,125
PUNJAB,2012,Bus (Private),199,58,257
PUNJAB,2012,Tempo/Vans (Government),4,0,4
PUNJAB,2012,Tempo/Vans (Private),254,53,307
PUNJAB,2012,Jeep (Government),6,0,6
PUNJAB,2012,Jeep (Private),218,55,273
PUNJAB,2012,Car (Government),5,2,7
PUNJAB,2012,Car (Private),631,139,770
PUNJAB,2012,Three Wheeler,85,13,98
PUNJAB,2012,Two Wheeler,1034,115,1149
PUNJAB,2012,Bicycle,135,8,143
PUNJAB,2012,Pedestrian,209,43,252
PUNJAB,2012,Others (Please Specify),504,102,606
PUNJAB,2012,Total Deaths (Persons),4037,758,4795
PUNJAB,2012,Total Truck/Lorry,662,136,798
PUNJAB,2012,Total Bus,290,92,382
PUNJAB,2012,Total Tempo/Vans,258,53,311
PUNJAB,2012,Total Jeep,224,55,279
PUNJAB,2012,Total Car,636,141,777
RAJASTHAN,2001,Truck/Lorry (Government),7,0,7
RAJASTHAN,2001,Truck/Lorry (Private),1239,139,1378
RAJASTHAN,2001,Bus (Government),102,17,119
RAJASTHAN,2001,Bus (Private),362,93,455
RAJASTHAN,2001,Tempo/Vans (Government),0,0,0
RAJASTHAN,2001,Tempo/Vans (Private),79,25,104
RAJASTHAN,2001,Jeep (Government),12,0,12
RAJASTHAN,2001,Jeep (Private),994,232,1226
RAJASTHAN,2001,Car (Government),1,0,1
RAJASTHAN,2001,Car (Private),189,62,251
RAJASTHAN,2001,Three Wheeler,58,16,74
RAJASTHAN,2001,Two Wheeler,459,75,534
RAJASTHAN,2001,Bicycle,116,0,116
RAJASTHAN,2001,Pedestrian,346,103,449
RAJASTHAN,2001,Others (Please Specify),394,67,461
RAJASTHAN,2001,Total Deaths (Persons),4358,829,5187
RAJASTHAN,2001,Total Truck/Lorry,1246,139,1385
RAJASTHAN,2001,Total Bus,464,110,574
RAJASTHAN,2001,Total Tempo/Vans,79,25,104
RAJASTHAN,2001,Total Jeep,1006,232,1238
RAJASTHAN,2001,Total Car,190,62,252
RAJASTHAN,2002,Truck/Lorry (Government),19,0,19
RAJASTHAN,2002,Truck/Lorry (Private),1369,136,1505
RAJASTHAN,2002,Bus (Government),113,22,135
RAJASTHAN,2002,Bus (Private),421,90,511
RAJASTHAN,2002,Tempo/Vans (Government),0,0,0
RAJASTHAN,2002,Tempo/Vans (Private),70,10,80
RAJASTHAN,2002,Jeep (Government),15,0,15
RAJASTHAN,2002,Jeep (Private),890,202,1092
RAJASTHAN,2002,Car (Government),2,0,2
RAJASTHAN,2002,Car (Private),173,50,223
RAJASTHAN,2002,Three Wheeler,62,15,77
RAJASTHAN,2002,Two Wheeler,551,117,668
RAJASTHAN,2002,Bicycle,134,10,144
RAJASTHAN,2002,Pedestrian,378,97,475
RAJASTHAN,2002,Others (Please Specify),515,74,589
RAJASTHAN,2002,Total Deaths (Persons),4712,823,5535
RAJASTHAN,2002,Total Truck/Lorry,1388,136,1524
RAJASTHAN,2002,Total Bus,534,112,646
RAJASTHAN,2002,Total Tempo/Vans,70,10,80
RAJASTHAN,2002,Total Jeep,905,202,1107
RAJASTHAN,2002,Total Car,175,50,225
RAJASTHAN,2003,Truck/Lorry (Government),54,3,57
RAJASTHAN,2003,Truck/Lorry (Private),1484,116,1600
RAJASTHAN,2003,Bus (Government),55,19,74
RAJASTHAN,2003,Bus (Private),428,97,525
RAJASTHAN,2003,Tempo/Vans (Government),1,0,1
RAJASTHAN,2003,Tempo/Vans (Private),70,24,94
RAJASTHAN,2003,Jeep (Government),3,4,7
RAJASTHAN,2003,Jeep (Private),895,233,1128
RAJASTHAN,2003,Car (Government),2,0,2
RAJASTHAN,2003,Car (Private),211,54,265
RAJASTHAN,2003,Three Wheeler,95,25,120
RAJASTHAN,2003,Two Wheeler,611,107,718
RAJASTHAN,2003,Bicycle,113,7,120
RAJASTHAN,2003,Pedestrian,431,118,549
RAJASTHAN,2003,Others (Please Specify),654,111,765
RAJASTHAN,2003,Total Deaths (Persons),5107,918,6025
RAJASTHAN,2003,Total Truck/Lorry,1538,119,1657
RAJASTHAN,2003,Total Bus,483,116,599
RAJASTHAN,2003,Total Tempo/Vans,71,24,95
RAJASTHAN,2003,Total Jeep,898,237,1135
RAJASTHAN,2003,Total Car,213,54,267
RAJASTHAN,2004,Truck/Lorry (Government),97,9,106
RAJASTHAN,2004,Truck/Lorry (Private),1365,107,1472
RAJASTHAN,2004,Bus (Government),48,6,54
RAJASTHAN,2004,Bus (Private),389,63,452
RAJASTHAN,2004,Tempo/Vans (Government),0,0,0
RAJASTHAN,2004,Tempo/Vans (Private),115,31,146
RAJASTHAN,2004,Jeep (Government),8,1,9
RAJASTHAN,2004,Jeep (Private),942,208,1150
RAJASTHAN,2004,Car (Government),13,0,13
RAJASTHAN,2004,Car (Private),315,41,356
RAJASTHAN,2004,Three Wheeler,115,23,138
RAJASTHAN,2004,Two Wheeler,879,130,1009
RAJASTHAN,2004,Bicycle,178,37,215
RAJASTHAN,2004,Pedestrian,488,90,578
RAJASTHAN,2004,Others (Please Specify),675,104,779
RAJASTHAN,2004,Total Deaths (Persons),5627,850,6477
RAJASTHAN,2004,Total Truck/Lorry,1462,116,1578
RAJASTHAN,2004,Total Bus,437,69,506
RAJASTHAN,2004,Total Tempo/Vans,115,31,146
RAJASTHAN,2004,Total Jeep,950,209,1159
RAJASTHAN,2004,Total Car,328,41,369
RAJASTHAN,2005,Truck/Lorry (Government),23,8,31
RAJASTHAN,2005,Truck/Lorry (Private),1646,160,1806
RAJASTHAN,2005,Bus (Government),70,14,84
RAJASTHAN,2005,Bus (Private),413,94,507
RAJASTHAN,2005,Tempo/Vans (Government),0,0,0
RAJASTHAN,2005,Tempo/Vans (Private),110,22,132
RAJASTHAN,2005,Jeep (Government),44,6,50
RAJASTHAN,2005,Jeep (Private),922,206,1128
RAJASTHAN,2005,Car (Government),8,1,9
RAJASTHAN,2005,Car (Private),264,48,312
RAJASTHAN,2005,Three Wheeler,119,23,142
RAJASTHAN,2005,Two Wheeler,775,178,953
RAJASTHAN,2005,Bicycle,82,1,83
RAJASTHAN,2005,Pedestrian,478,70,548
RAJASTHAN,2005,Others (Please Specify),882,126,1008
RAJASTHAN,2005,Total Deaths (Persons),5836,957,6793
RAJASTHAN,2005,Total Truck/Lorry,1669,168,1837
RAJASTHAN,2005,Total Bus,483,108,591
RAJASTHAN,2005,Total Tempo/Vans,110,22,132
RAJASTHAN,2005,Total Jeep,966,212,1178
RAJASTHAN,2005,Total Car,272,49,321
RAJASTHAN,2006,Truck/Lorry (Government),15,5,20
RAJASTHAN,2006,Truck/Lorry (Private),1435,136,1571
RAJASTHAN,2006,Bus (Government),91,18,109
RAJASTHAN,2006,Bus (Private),388,122,510
RAJASTHAN,2006,Tempo/Vans (Government),0,0,0
RAJASTHAN,2006,Tempo/Vans (Private),26,8,34
RAJASTHAN,2006,Jeep (Government),7,0,7
RAJASTHAN,2006,Jeep (Private),1096,275,1371
RAJASTHAN,2006,Car (Government),2,0,2
RAJASTHAN,2006,Car (Private),284,84,368
RAJASTHAN,2006,Three Wheeler,194,18,212
RAJASTHAN,2006,Two Wheeler,939,170,1109
RAJASTHAN,2006,Bicycle,113,7,120
RAJASTHAN,2006,Pedestrian,653,132,785
RAJASTHAN,2006,Others (Please Specify),802,134,936
RAJASTHAN,2006,Total Deaths (Persons),6045,1109,7154
RAJASTHAN,2006,Total Truck/Lorry,1450,141,1591
RAJASTHAN,2006,Total Bus,479,140,619
RAJASTHAN,2006,Total Tempo/Vans,26,8,34
RAJASTHAN,2006,Total Jeep,1103,275,1378
RAJASTHAN,2006,Total Car,286,84,370
RAJASTHAN,2007,Truck/Lorry (Government),4,0,4
RAJASTHAN,2007,Truck/Lorry (Private),1477,241,1718
RAJASTHAN,2007,Bus (Government),62,17,79
RAJASTHAN,2007,Bus (Private),404,95,499
RAJASTHAN,2007,Tempo/Vans (Government),0,0,0
RAJASTHAN,2007,Tempo/Vans (Private),207,46,253
RAJASTHAN,2007,Jeep (Government),8,1,9
RAJASTHAN,2007,Jeep (Private),1059,255,1314
RAJASTHAN,2007,Car (Government),2,0,2
RAJASTHAN,2007,Car (Private),301,96,397
RAJASTHAN,2007,Three Wheeler,140,42,182
RAJASTHAN,2007,Two Wheeler,1224,192,1416
RAJASTHAN,2007,Bicycle,99,13,112
RAJASTHAN,2007,Pedestrian,603,142,745
RAJASTHAN,2007,Others (Please Specify),1184,231,1415
RAJASTHAN,2007,Total Deaths (Persons),6774,1371,8145
RAJASTHAN,2007,Total Truck/Lorry,1481,241,1722
RAJASTHAN,2007,Total Bus,466,112,578
RAJASTHAN,2007,Total Tempo/Vans,207,46,253
RAJASTHAN,2007,Total Jeep,1067,256,1323
RAJASTHAN,2007,Total Car,303,96,399
RAJASTHAN,2008,Truck/Lorry (Government),60,2,62
RAJASTHAN,2008,Truck/Lorry (Private),1421,148,1569
RAJASTHAN,2008,Bus (Government),50,15,65
RAJASTHAN,2008,Bus (Private),560,131,691
RAJASTHAN,2008,Tempo/Vans (Government),2,0,2
RAJASTHAN,2008,Tempo/Vans (Private),256,50,306
RAJASTHAN,2008,Jeep (Government),45,3,48
RAJASTHAN,2008,Jeep (Private),1020,203,1223
RAJASTHAN,2008,Car (Government),13,2,15
RAJASTHAN,2008,Car (Private),440,86,526
RAJASTHAN,2008,Three Wheeler,163,39,202
RAJASTHAN,2008,Two Wheeler,1455,198,1653
RAJASTHAN,2008,Bicycle,95,10,105
RAJASTHAN,2008,Pedestrian,546,141,687
RAJASTHAN,2008,Others (Please Specify),1068,166,1234
RAJASTHAN,2008,Total Deaths (Persons),7194,1194,8388
RAJASTHAN,2008,Total Truck/Lorry,1481,150,1631
RAJASTHAN,2008,Total Bus,610,146,756
RAJASTHAN,2008,Total Tempo/Vans,258,50,308
RAJASTHAN,2008,Total Jeep,1065,206,1271
RAJASTHAN,2008,Total Car,453,88,541
RAJASTHAN,2009,Truck/Lorry (Government),21,0,21
RAJASTHAN,2009,Truck/Lorry (Private),1632,188,1820
RAJASTHAN,2009,Bus (Government),80,24,104
RAJASTHAN,2009,Bus (Private),505,111,616
RAJASTHAN,2009,Tempo/Vans (Government),2,0,2
RAJASTHAN,2009,Tempo/Vans (Private),152,40,192
RAJASTHAN,2009,Jeep (Government),13,2,15
RAJASTHAN,2009,Jeep (Private),1138,237,1375
RAJASTHAN,2009,Car (Government),2,0,2
RAJASTHAN,2009,Car (Private),392,110,502
RAJASTHAN,2009,Three Wheeler,236,54,290
RAJASTHAN,2009,Two Wheeler,1505,169,1674
RAJASTHAN,2009,Bicycle,91,12,103
RAJASTHAN,2009,Pedestrian,478,137,615
RAJASTHAN,2009,Others (Please Specify),1476,238,1714
RAJASTHAN,2009,Total Deaths (Persons),7723,1322,9045
RAJASTHAN,2009,Total Truck/Lorry,1653,188,1841
RAJASTHAN,2009,Total Bus,585,135,720
RAJASTHAN,2009,Total Tempo/Vans,154,40,194
RAJASTHAN,2009,Total Jeep,1151,239,1390
RAJASTHAN,2009,Total Car,394,110,504
RAJASTHAN,2010,Truck/Lorry (Government),1,0,1
RAJASTHAN,2010,Truck/Lorry (Private),1525,110,1635
RAJASTHAN,2010,Bus (Government),75,15,90
RAJASTHAN,2010,Bus (Private),522,145,667
RAJASTHAN,2010,Tempo/Vans (Government),7,1,8
RAJASTHAN,2010,Tempo/Vans (Private),253,53,306
RAJASTHAN,2010,Jeep (Government),4,0,4
RAJASTHAN,2010,Jeep (Private),1096,212,1308
RAJASTHAN,2010,Car (Government),8,5,13
RAJASTHAN,2010,Car (Private),525,109,634
RAJASTHAN,2010,Three Wheeler,179,44,223
RAJASTHAN,2010,Two Wheeler,1795,198,1993
RAJASTHAN,2010,Bicycle,124,8,132
RAJASTHAN,2010,Pedestrian,715,177,892
RAJASTHAN,2010,Others (Please Specify),1116,141,1257
RAJASTHAN,2010,Total Deaths (Persons),7945,1218,9163
RAJASTHAN,2010,Total Truck/Lorry,1526,110,1636
RAJASTHAN,2010,Total Bus,597,160,757
RAJASTHAN,2010,Total Tempo/Vans,260,54,314
RAJASTHAN,2010,Total Jeep,1100,212,1312
RAJASTHAN,2010,Total Car,533,114,647
RAJASTHAN,2011,Truck/Lorry (Government),59,9,68
RAJASTHAN,2011,Truck/Lorry (Private),1457,91,1548
RAJASTHAN,2011,Bus (Government),61,14,75
RAJASTHAN,2011,Bus (Private),529,112,641
RAJASTHAN,2011,Tempo/Vans (Government),0,0,0
RAJASTHAN,2011,Tempo/Vans (Private),215,49,264
RAJASTHAN,2011,Jeep (Government),0,0,0
RAJASTHAN,2011,Jeep (Private),1184,227,1411
RAJASTHAN,2011,Car (Government),1,0,1
RAJASTHAN,2011,Car (Private),614,137,751
RAJASTHAN,2011,Three Wheeler,201,32,233
RAJASTHAN,2011,Two Wheeler,1731,266,1997
RAJASTHAN,2011,Bicycle,126,7,133
RAJASTHAN,2011,Pedestrian,752,174,926
RAJASTHAN,2011,Others (Please Specify),1048,136,1184
RAJASTHAN,2011,Total Deaths (Persons),7978,1254,9232
RAJASTHAN,2011,Total Truck/Lorry,1516,100,1616
RAJASTHAN,2011,Total Bus,590,126,716
RAJASTHAN,2011,Total Tempo/Vans,215,49,264
RAJASTHAN,2011,Total Jeep,1184,227,1411
RAJASTHAN,2011,Total Car,615,137,752
RAJASTHAN,2012,Truck/Lorry (Government),6,2,8
RAJASTHAN,2012,Truck/Lorry (Private),1391,117,1508
RAJASTHAN,2012,Bus (Government),118,28,146
RAJASTHAN,2012,Bus (Private),561,118,679
RAJASTHAN,2012,Tempo/Vans (Government),2,0,2
RAJASTHAN,2012,Tempo/Vans (Private),159,29,188
RAJASTHAN,2012,Jeep (Government),5,0,5
RAJASTHAN,2012,Jeep (Private),1137,209,1346
RAJASTHAN,2012,Car (Government),4,0,4
RAJASTHAN,2012,Car (Private),654,133,787
RAJASTHAN,2012,Three Wheeler,150,32,182
RAJASTHAN,2012,Two Wheeler,1918,278,2196
RAJASTHAN,2012,Bicycle,111,8,119
RAJASTHAN,2012,Pedestrian,871,211,1082
RAJASTHAN,2012,Others (Please Specify),1130,146,1276
RAJASTHAN,2012,Total Deaths (Persons),8217,1311,9528
RAJASTHAN,2012,Total Truck/Lorry,1397,119,1516
RAJASTHAN,2012,Total Bus,679,146,825
RAJASTHAN,2012,Total Tempo/Vans,161,29,190
RAJASTHAN,2012,Total Jeep,1142,209,1351
RAJASTHAN,2012,Total Car,658,133,791
SIKKIM,2001,Truck/Lorry (Government),3,0,3
SIKKIM,2001,Truck/Lorry (Private),4,0,4
SIKKIM,2001,Bus (Government),0,0,0
SIKKIM,2001,Bus (Private),0,0,0
SIKKIM,2001,Tempo/Vans (Government),0,0,0
SIKKIM,2001,Tempo/Vans (Private),1,0,1
SIKKIM,2001,Jeep (Government),5,0,5
SIKKIM,2001,Jeep (Private),19,9,28
SIKKIM,2001,Car (Government),0,0,0
SIKKIM,2001,Car (Private),3,0,3
SIKKIM,2001,Three Wheeler,0,0,0
SIKKIM,2001,Two Wheeler,1,0,1
SIKKIM,2001,Bicycle,0,0,0
SIKKIM,2001,Pedestrian,0,0,0
SIKKIM,2001,Others (Please Specify),0,0,0
SIKKIM,2001,Total Deaths (Persons),36,9,45
SIKKIM,2001,Total Truck/Lorry,7,0,7
SIKKIM,2001,Total Bus,0,0,0
SIKKIM,2001,Total Tempo/Vans,1,0,1
SIKKIM,2001,Total Jeep,24,9,33
SIKKIM,2001,Total Car,3,0,3
SIKKIM,2002,Truck/Lorry (Government),1,5,6
SIKKIM,2002,Truck/Lorry (Private),1,0,1
SIKKIM,2002,Bus (Government),0,0,0
SIKKIM,2002,Bus (Private),0,0,0
SIKKIM,2002,Tempo/Vans (Government),0,0,0
SIKKIM,2002,Tempo/Vans (Private),3,0,3
SIKKIM,2002,Jeep (Government),14,0,14
SIKKIM,2002,Jeep (Private),10,10,20
SIKKIM,2002,Car (Government),0,0,0
SIKKIM,2002,Car (Private),0,0,0
SIKKIM,2002,Three Wheeler,0,0,0
SIKKIM,2002,Two Wheeler,2,0,2
SIKKIM,2002,Bicycle,0,0,0
SIKKIM,2002,Pedestrian,2,1,3
SIKKIM,2002,Others (Please Specify),2,4,6
SIKKIM,2002,Total Deaths (Persons),35,20,55
SIKKIM,2002,Total Truck/Lorry,2,5,7
SIKKIM,2002,Total Bus,0,0,0
SIKKIM,2002,Total Tempo/Vans,3,0,3
SIKKIM,2002,Total Jeep,24,10,34
SIKKIM,2002,Total Car,0,0,0
SIKKIM,2003,Truck/Lorry (Government),0,0,0
SIKKIM,2003,Truck/Lorry (Private),3,2,5
SIKKIM,2003,Bus (Government),0,0,0
SIKKIM,2003,Bus (Private),0,0,0
SIKKIM,2003,Tempo/Vans (Government),0,0,0
SIKKIM,2003,Tempo/Vans (Private),0,0,0
SIKKIM,2003,Jeep (Government),0,0,0
SIKKIM,2003,Jeep (Private),21,8,29
SIKKIM,2003,Car (Government),0,0,0
SIKKIM,2003,Car (Private),2,0,2
SIKKIM,2003,Three Wheeler,0,0,0
SIKKIM,2003,Two Wheeler,2,0,2
SIKKIM,2003,Bicycle,0,0,0
SIKKIM,2003,Pedestrian,2,0,2
SIKKIM,2003,Others (Please Specify),0,0,0
SIKKIM,2003,Total Deaths (Persons),30,10,40
SIKKIM,2003,Total Truck/Lorry,3,2,5
SIKKIM,2003,Total Bus,0,0,0
SIKKIM,2003,Total Tempo/Vans,0,0,0
SIKKIM,2003,Total Jeep,21,8,29
SIKKIM,2003,Total Car,2,0,2
SIKKIM,2004,Truck/Lorry (Government),0,0,0
SIKKIM,2004,Truck/Lorry (Private),3,0,3
SIKKIM,2004,Bus (Government),0,0,0
SIKKIM,2004,Bus (Private),0,0,0
SIKKIM,2004,Tempo/Vans (Government),0,0,0
SIKKIM,2004,Tempo/Vans (Private),1,1,2
SIKKIM,2004,Jeep (Government),0,0,0
SIKKIM,2004,Jeep (Private),31,12,43
SIKKIM,2004,Car (Government),0,0,0
SIKKIM,2004,Car (Private),0,0,0
SIKKIM,2004,Three Wheeler,0,0,0
SIKKIM,2004,Two Wheeler,3,0,3
SIKKIM,2004,Bicycle,0,0,0
SIKKIM,2004,Pedestrian,0,0,0
SIKKIM,2004,Others (Please Specify),0,0,0
SIKKIM,2004,Total Deaths (Persons),38,13,51
SIKKIM,2004,Total Truck/Lorry,3,0,3
SIKKIM,2004,Total Bus,0,0,0
SIKKIM,2004,Total Tempo/Vans,1,1,2
SIKKIM,2004,Total Jeep,31,12,43
SIKKIM,2004,Total Car,0,0,0
SIKKIM,2005,Truck/Lorry (Government),0,0,0
SIKKIM,2005,Truck/Lorry (Private),17,2,19
SIKKIM,2005,Bus (Government),0,0,0
SIKKIM,2005,Bus (Private),0,0,0
SIKKIM,2005,Tempo/Vans (Government),0,0,0
SIKKIM,2005,Tempo/Vans (Private),2,0,2
SIKKIM,2005,Jeep (Government),0,0,0
SIKKIM,2005,Jeep (Private),43,7,50
SIKKIM,2005,Car (Government),0,0,0
SIKKIM,2005,Car (Private),0,2,2
SIKKIM,2005,Three Wheeler,0,0,0
SIKKIM,2005,Two Wheeler,1,0,1
SIKKIM,2005,Bicycle,0,0,0
SIKKIM,2005,Pedestrian,1,1,2
SIKKIM,2005,Others (Please Specify),1,0,1
SIKKIM,2005,Total Deaths (Persons),65,12,77
SIKKIM,2005,Total Truck/Lorry,17,2,19
SIKKIM,2005,Total Bus,0,0,0
SIKKIM,2005,Total Tempo/Vans,2,0,2
SIKKIM,2005,Total Jeep,43,7,50
SIKKIM,2005,Total Car,0,2,2
SIKKIM,2006,Truck/Lorry (Government),0,0,0
SIKKIM,2006,Truck/Lorry (Private),20,2,22
SIKKIM,2006,Bus (Government),15,17,32
SIKKIM,2006,Bus (Private),0,0,0
SIKKIM,2006,Tempo/Vans (Government),0,0,0
SIKKIM,2006,Tempo/Vans (Private),0,0,0
SIKKIM,2006,Jeep (Government),0,0,0
SIKKIM,2006,Jeep (Private),19,9,28
SIKKIM,2006,Car (Government),0,0,0
SIKKIM,2006,Car (Private),5,1,6
SIKKIM,2006,Three Wheeler,0,0,0
SIKKIM,2006,Two Wheeler,0,0,0
SIKKIM,2006,Bicycle,0,0,0
SIKKIM,2006,Pedestrian,0,0,0
SIKKIM,2006,Others (Please Specify),0,0,0
SIKKIM,2006,Total Deaths (Persons),59,29,88
SIKKIM,2006,Total Truck/Lorry,20,2,22
SIKKIM,2006,Total Bus,15,17,32
SIKKIM,2006,Total Tempo/Vans,0,0,0
SIKKIM,2006,Total Jeep,19,9,28
SIKKIM,2006,Total Car,5,1,6
SIKKIM,2007,Truck/Lorry (Government),0,0,0
SIKKIM,2007,Truck/Lorry (Private),9,1,10
SIKKIM,2007,Bus (Government),10,3,13
SIKKIM,2007,Bus (Private),0,0,0
SIKKIM,2007,Tempo/Vans (Government),0,0,0
SIKKIM,2007,Tempo/Vans (Private),0,0,0
SIKKIM,2007,Jeep (Government),0,0,0
SIKKIM,2007,Jeep (Private),10,4,14
SIKKIM,2007,Car (Government),0,0,0
SIKKIM,2007,Car (Private),3,3,6
SIKKIM,2007,Three Wheeler,0,0,0
SIKKIM,2007,Two Wheeler,2,0,2
SIKKIM,2007,Bicycle,0,0,0
SIKKIM,2007,Pedestrian,0,0,0
SIKKIM,2007,Others (Please Specify),6,1,7
SIKKIM,2007,Total Deaths (Persons),40,12,52
SIKKIM,2007,Total Truck/Lorry,9,1,10
SIKKIM,2007,Total Bus,10,3,13
SIKKIM,2007,Total Tempo/Vans,0,0,0
SIKKIM,2007,Total Jeep,10,4,14
SIKKIM,2007,Total Car,3,3,6
SIKKIM,2008,Truck/Lorry (Government),0,0,0
SIKKIM,2008,Truck/Lorry (Private),10,0,10
SIKKIM,2008,Bus (Government),0,0,0
SIKKIM,2008,Bus (Private),0,0,0
SIKKIM,2008,Tempo/Vans (Government),0,0,0
SIKKIM,2008,Tempo/Vans (Private),0,0,0
SIKKIM,2008,Jeep (Government),0,0,0
SIKKIM,2008,Jeep (Private),0,0,0
SIKKIM,2008,Car (Government),0,0,0
SIKKIM,2008,Car (Private),0,0,0
SIKKIM,2008,Three Wheeler,0,0,0
SIKKIM,2008,Two Wheeler,1,0,1
SIKKIM,2008,Bicycle,0,0,0
SIKKIM,2008,Pedestrian,0,0,0
SIKKIM,2008,Others (Please Specify),56,12,68
SIKKIM,2008,Total Deaths (Persons),67,12,79
SIKKIM,2008,Total Truck/Lorry,10,0,10
SIKKIM,2008,Total Bus,0,0,0
SIKKIM,2008,Total Tempo/Vans,0,0,0
SIKKIM,2008,Total Jeep,0,0,0
SIKKIM,2008,Total Car,0,0,0
SIKKIM,2009,Truck/Lorry (Government),0,0,0
SIKKIM,2009,Truck/Lorry (Private),1,0,1
SIKKIM,2009,Bus (Government),0,0,0
SIKKIM,2009,Bus (Private),0,0,0
SIKKIM,2009,Tempo/Vans (Government),0,0,0
SIKKIM,2009,Tempo/Vans (Private),0,0,0
SIKKIM,2009,Jeep (Government),0,0,0
SIKKIM,2009,Jeep (Private),42,40,82
SIKKIM,2009,Car (Government),0,0,0
SIKKIM,2009,Car (Private),2,0,2
SIKKIM,2009,Three Wheeler,0,0,0
SIKKIM,2009,Two Wheeler,0,0,0
SIKKIM,2009,Bicycle,0,0,0
SIKKIM,2009,Pedestrian,1,0,1
SIKKIM,2009,Others (Please Specify),1,0,1
SIKKIM,2009,Total Deaths (Persons),47,40,87
SIKKIM,2009,Total Truck/Lorry,1,0,1
SIKKIM,2009,Total Bus,0,0,0
SIKKIM,2009,Total Tempo/Vans,0,0,0
SIKKIM,2009,Total Jeep,42,40,82
SIKKIM,2009,Total Car,2,0,2
SIKKIM,2010,Truck/Lorry (Government),0,0,0
SIKKIM,2010,Truck/Lorry (Private),0,0,0
SIKKIM,2010,Bus (Government),0,0,0
SIKKIM,2010,Bus (Private),0,0,0
SIKKIM,2010,Tempo/Vans (Government),0,0,0
SIKKIM,2010,Tempo/Vans (Private),0,0,0
SIKKIM,2010,Jeep (Government),0,0,0
SIKKIM,2010,Jeep (Private),52,14,66
SIKKIM,2010,Car (Government),0,0,0
SIKKIM,2010,Car (Private),3,2,5
SIKKIM,2010,Three Wheeler,0,0,0
SIKKIM,2010,Two Wheeler,0,0,0
SIKKIM,2010,Bicycle,0,0,0
SIKKIM,2010,Pedestrian,0,0,0
SIKKIM,2010,Others (Please Specify),0,0,0
SIKKIM,2010,Total Deaths (Persons),55,16,71
SIKKIM,2010,Total Truck/Lorry,0,0,0
SIKKIM,2010,Total Bus,0,0,0
SIKKIM,2010,Total Tempo/Vans,0,0,0
SIKKIM,2010,Total Jeep,52,14,66
SIKKIM,2010,Total Car,3,2,5
SIKKIM,2011,Truck/Lorry (Government),0,0,0
SIKKIM,2011,Truck/Lorry (Private),2,2,4
SIKKIM,2011,Bus (Government),0,0,0
SIKKIM,2011,Bus (Private),0,0,0
SIKKIM,2011,Tempo/Vans (Government),0,0,0
SIKKIM,2011,Tempo/Vans (Private),0,0,0
SIKKIM,2011,Jeep (Government),0,0,0
SIKKIM,2011,Jeep (Private),82,15,97
SIKKIM,2011,Car (Government),0,0,0
SIKKIM,2011,Car (Private),3,2,5
SIKKIM,2011,Three Wheeler,0,0,0
SIKKIM,2011,Two Wheeler,0,0,0
SIKKIM,2011,Bicycle,0,0,0
SIKKIM,2011,Pedestrian,0,0,0
SIKKIM,2011,Others (Please Specify),0,0,0
SIKKIM,2011,Total Deaths (Persons),87,19,106
SIKKIM,2011,Total Truck/Lorry,2,2,4
SIKKIM,2011,Total Bus,0,0,0
SIKKIM,2011,Total Tempo/Vans,0,0,0
SIKKIM,2011,Total Jeep,82,15,97
SIKKIM,2011,Total Car,3,2,5
SIKKIM,2012,Truck/Lorry (Government),0,0,0
SIKKIM,2012,Truck/Lorry (Private),10,3,13
SIKKIM,2012,Bus (Government),0,0,0
SIKKIM,2012,Bus (Private),0,0,0
SIKKIM,2012,Tempo/Vans (Government),0,0,0
SIKKIM,2012,Tempo/Vans (Private),2,0,2
SIKKIM,2012,Jeep (Government),3,1,4
SIKKIM,2012,Jeep (Private),19,2,21
SIKKIM,2012,Car (Government),0,0,0
SIKKIM,2012,Car (Private),2,0,2
SIKKIM,2012,Three Wheeler,0,0,0
SIKKIM,2012,Two Wheeler,1,0,1
SIKKIM,2012,Bicycle,0,1,1
SIKKIM,2012,Pedestrian,0,0,0
SIKKIM,2012,Others (Please Specify),0,0,0
SIKKIM,2012,Total Deaths (Persons),37,7,44
SIKKIM,2012,Total Truck/Lorry,10,3,13
SIKKIM,2012,Total Bus,0,0,0
SIKKIM,2012,Total Tempo/Vans,2,0,2
SIKKIM,2012,Total Jeep,22,3,25
SIKKIM,2012,Total Car,2,0,2
TAMIL NADU,2001,Truck/Lorry (Government),5,2,7
TAMIL NADU,2001,Truck/Lorry (Private),2819,380,3199
TAMIL NADU,2001,Bus (Government),1251,235,1486
TAMIL NADU,2001,Bus (Private),603,156,759
TAMIL NADU,2001,Tempo/Vans (Government),29,5,34
TAMIL NADU,2001,Tempo/Vans (Private),839,230,1069
TAMIL NADU,2001,Jeep (Government),22,8,30
TAMIL NADU,2001,Jeep (Private),173,40,213
TAMIL NADU,2001,Car (Government),37,1,38
TAMIL NADU,2001,Car (Private),511,163,674
TAMIL NADU,2001,Three Wheeler,168,33,201
TAMIL NADU,2001,Two Wheeler,871,174,1045
TAMIL NADU,2001,Bicycle,81,31,112
TAMIL NADU,2001,Pedestrian,93,87,180
TAMIL NADU,2001,Others (Please Specify),372,152,524
TAMIL NADU,2001,Total Deaths (Persons),7874,1697,9571
TAMIL NADU,2001,Total Truck/Lorry,2824,382,3206
TAMIL NADU,2001,Total Bus,1854,391,2245
TAMIL NADU,2001,Total Tempo/Vans,868,235,1103
TAMIL NADU,2001,Total Jeep,195,48,243
TAMIL NADU,2001,Total Car,548,164,712
TAMIL NADU,2002,Truck/Lorry (Government),33,9,42
TAMIL NADU,2002,Truck/Lorry (Private),2631,425,3056
TAMIL NADU,2002,Bus (Government),1229,205,1434
TAMIL NADU,2002,Bus (Private),708,192,900
TAMIL NADU,2002,Tempo/Vans (Government),6,6,12
TAMIL NADU,2002,Tempo/Vans (Private),807,190,997
TAMIL NADU,2002,Jeep (Government),14,3,17
TAMIL NADU,2002,Jeep (Private),130,29,159
TAMIL NADU,2002,Car (Government),25,12,37
TAMIL NADU,2002,Car (Private),755,171,926
TAMIL NADU,2002,Three Wheeler,215,38,253
TAMIL NADU,2002,Two Wheeler,1110,74,1184
TAMIL NADU,2002,Bicycle,167,16,183
TAMIL NADU,2002,Pedestrian,335,92,427
TAMIL NADU,2002,Others (Please Specify),266,46,312
TAMIL NADU,2002,Total Deaths (Persons),8431,1508,9939
TAMIL NADU,2002,Total Truck/Lorry,2664,434,3098
TAMIL NADU,2002,Total Bus,1937,397,2334
TAMIL NADU,2002,Total Tempo/Vans,813,196,1009
TAMIL NADU,2002,Total Jeep,144,32,176
TAMIL NADU,2002,Total Car,780,183,963
TAMIL NADU,2003,Truck/Lorry (Government),11,1,12
TAMIL NADU,2003,Truck/Lorry (Private),2444,416,2860
TAMIL NADU,2003,Bus (Government),1007,250,1257
TAMIL NADU,2003,Bus (Private),623,167,790
TAMIL NADU,2003,Tempo/Vans (Government),14,3,17
TAMIL NADU,2003,Tempo/Vans (Private),719,171,890
TAMIL NADU,2003,Jeep (Government),5,2,7
TAMIL NADU,2003,Jeep (Private),136,26,162
TAMIL NADU,2003,Car (Government),5,1,6
TAMIL NADU,2003,Car (Private),769,181,950
TAMIL NADU,2003,Three Wheeler,274,43,317
TAMIL NADU,2003,Two Wheeler,1046,172,1218
TAMIL NADU,2003,Bicycle,78,16,94
TAMIL NADU,2003,Pedestrian,409,75,484
TAMIL NADU,2003,Others (Please Specify),152,59,211
TAMIL NADU,2003,Total Deaths (Persons),7692,1583,9275
TAMIL NADU,2003,Total Truck/Lorry,2455,417,2872
TAMIL NADU,2003,Total Bus,1630,417,2047
TAMIL NADU,2003,Total Tempo/Vans,733,174,907
TAMIL NADU,2003,Total Jeep,141,28,169
TAMIL NADU,2003,Total Car,774,182,956
TAMIL NADU,2004,Truck/Lorry (Government),5,2,7
TAMIL NADU,2004,Truck/Lorry (Private),2424,297,2721
TAMIL NADU,2004,Bus (Government),1007,191,1198
TAMIL NADU,2004,Bus (Private),607,128,735
TAMIL NADU,2004,Tempo/Vans (Government),9,1,10
TAMIL NADU,2004,Tempo/Vans (Private),759,210,969
TAMIL NADU,2004,Jeep (Government),10,0,10
TAMIL NADU,2004,Jeep (Private),85,17,102
TAMIL NADU,2004,Car (Government),14,7,21
TAMIL NADU,2004,Car (Private),867,172,1039
TAMIL NADU,2004,Three Wheeler,303,57,360
TAMIL NADU,2004,Two Wheeler,1213,211,1424
TAMIL NADU,2004,Bicycle,148,15,163
TAMIL NADU,2004,Pedestrian,262,104,366
TAMIL NADU,2004,Others (Please Specify),318,64,382
TAMIL NADU,2004,Total Deaths (Persons),8031,1476,9507
TAMIL NADU,2004,Total Truck/Lorry,2429,299,2728
TAMIL NADU,2004,Total Bus,1614,319,1933
TAMIL NADU,2004,Total Tempo/Vans,768,211,979
TAMIL NADU,2004,Total Jeep,95,17,112
TAMIL NADU,2004,Total Car,881,179,1060
TAMIL NADU,2005,Truck/Lorry (Government),2,2,4
TAMIL NADU,2005,Truck/Lorry (Private),2823,292,3115
TAMIL NADU,2005,Bus (Government),1483,299,1782
TAMIL NADU,2005,Bus (Private),948,278,1226
TAMIL NADU,2005,Tempo/Vans (Government),31,22,53
TAMIL NADU,2005,Tempo/Vans (Private),1287,214,1501
TAMIL NADU,2005,Jeep (Government),22,4,26
TAMIL NADU,2005,Jeep (Private),68,7,75
TAMIL NADU,2005,Car (Government),7,4,11
TAMIL NADU,2005,Car (Private),1389,275,1664
TAMIL NADU,2005,Three Wheeler,476,70,546
TAMIL NADU,2005,Two Wheeler,1945,383,2328
TAMIL NADU,2005,Bicycle,334,12,346
TAMIL NADU,2005,Pedestrian,735,174,909
TAMIL NADU,2005,Others (Please Specify),317,58,375
TAMIL NADU,2005,Total Deaths (Persons),11867,2094,13961
TAMIL NADU,2005,Total Truck/Lorry,2825,294,3119
TAMIL NADU,2005,Total Bus,2431,577,3008
TAMIL NADU,2005,Total Tempo/Vans,1318,236,1554
TAMIL NADU,2005,Total Jeep,90,11,101
TAMIL NADU,2005,Total Car,1396,279,1675
TAMIL NADU,2006,Truck/Lorry (Government),29,5,34
TAMIL NADU,2006,Truck/Lorry (Private),2387,183,2570
TAMIL NADU,2006,Bus (Government),1158,252,1410
TAMIL NADU,2006,Bus (Private),851,77,928
TAMIL NADU,2006,Tempo/Vans (Government),21,0,21
TAMIL NADU,2006,Tempo/Vans (Private),160,145,305
TAMIL NADU,2006,Jeep (Government),4,0,4
TAMIL NADU,2006,Jeep (Private),162,12,174
TAMIL NADU,2006,Car (Government),11,1,12
TAMIL NADU,2006,Car (Private),1859,239,2098
TAMIL NADU,2006,Three Wheeler,457,97,554
TAMIL NADU,2006,Two Wheeler,1909,263,2172
TAMIL NADU,2006,Bicycle,326,22,348
TAMIL NADU,2006,Pedestrian,290,89,379
TAMIL NADU,2006,Others (Please Specify),0,0,0
TAMIL NADU,2006,Total Deaths (Persons),9624,1385,11009
TAMIL NADU,2006,Total Truck/Lorry,2416,188,2604
TAMIL NADU,2006,Total Bus,2009,329,2338
TAMIL NADU,2006,Total Tempo/Vans,181,145,326
TAMIL NADU,2006,Total Jeep,166,12,178
TAMIL NADU,2006,Total Car,1870,240,2110
TAMIL NADU,2007,Truck/Lorry (Government),30,8,38
TAMIL NADU,2007,Truck/Lorry (Private),2480,276,2756
TAMIL NADU,2007,Bus (Government),807,255,1062
TAMIL NADU,2007,Bus (Private),1326,173,1499
TAMIL NADU,2007,Tempo/Vans (Government),22,0,22
TAMIL NADU,2007,Tempo/Vans (Private),167,219,386
TAMIL NADU,2007,Jeep (Government),4,0,4
TAMIL NADU,2007,Jeep (Private),168,18,186
TAMIL NADU,2007,Car (Government),11,2,13
TAMIL NADU,2007,Car (Private),1994,269,2263
TAMIL NADU,2007,Three Wheeler,475,146,621
TAMIL NADU,2007,Two Wheeler,1982,398,2380
TAMIL NADU,2007,Bicycle,340,32,372
TAMIL NADU,2007,Pedestrian,304,130,434
TAMIL NADU,2007,Others (Please Specify),0,0,0
TAMIL NADU,2007,Total Deaths (Persons),10110,1926,12036
TAMIL NADU,2007,Total Truck/Lorry,2510,284,2794
TAMIL NADU,2007,Total Bus,2133,428,2561
TAMIL NADU,2007,Total Tempo/Vans,189,219,408
TAMIL NADU,2007,Total Jeep,172,18,190
TAMIL NADU,2007,Total Car,2005,271,2276
TAMIL NADU,2008,Truck/Lorry (Government),24,8,32
TAMIL NADU,2008,Truck/Lorry (Private),2596,297,2893
TAMIL NADU,2008,Bus (Government),1027,507,1534
TAMIL NADU,2008,Bus (Private),779,163,942
TAMIL NADU,2008,Tempo/Vans (Government),22,0,22
TAMIL NADU,2008,Tempo/Vans (Private),195,217,412
TAMIL NADU,2008,Jeep (Government),17,0,17
TAMIL NADU,2008,Jeep (Private),185,27,212
TAMIL NADU,2008,Car (Government),13,4,17
TAMIL NADU,2008,Car (Private),1764,273,2037
TAMIL NADU,2008,Three Wheeler,415,123,538
TAMIL NADU,2008,Two Wheeler,2045,610,2655
TAMIL NADU,2008,Bicycle,496,315,811
TAMIL NADU,2008,Pedestrian,426,236,662
TAMIL NADU,2008,Others (Please Specify),0,0,0
TAMIL NADU,2008,Total Deaths (Persons),10004,2780,12784
TAMIL NADU,2008,Total Truck/Lorry,2620,305,2925
TAMIL NADU,2008,Total Bus,1806,670,2476
TAMIL NADU,2008,Total Tempo/Vans,217,217,434
TAMIL NADU,2008,Total Jeep,202,27,229
TAMIL NADU,2008,Total Car,1777,277,2054
TAMIL NADU,2009,Truck/Lorry (Government),120,14,134
TAMIL NADU,2009,Truck/Lorry (Private),2557,351,2908
TAMIL NADU,2009,Bus (Government),1223,316,1539
TAMIL NADU,2009,Bus (Private),786,201,987
TAMIL NADU,2009,Tempo/Vans (Government),18,2,20
TAMIL NADU,2009,Tempo/Vans (Private),649,113,762
TAMIL NADU,2009,Jeep (Government),23,3,26
TAMIL NADU,2009,Jeep (Private),164,19,183
TAMIL NADU,2009,Car (Government),178,16,194
TAMIL NADU,2009,Car (Private),2228,344,2572
TAMIL NADU,2009,Three Wheeler,391,107,498
TAMIL NADU,2009,Two Wheeler,2917,334,3251
TAMIL NADU,2009,Bicycle,307,44,351
TAMIL NADU,2009,Pedestrian,130,48,178
TAMIL NADU,2009,Others (Please Specify),91,52,143
TAMIL NADU,2009,Total Deaths (Persons),11782,1964,13746
TAMIL NADU,2009,Total Truck/Lorry,2677,365,3042
TAMIL NADU,2009,Total Bus,2009,517,2526
TAMIL NADU,2009,Total Tempo/Vans,667,115,782
TAMIL NADU,2009,Total Jeep,187,22,209
TAMIL NADU,2009,Total Car,2406,360,2766
TAMIL NADU,2010,Truck/Lorry (Government),41,21,62
TAMIL NADU,2010,Truck/Lorry (Private),2546,497,3043
TAMIL NADU,2010,Bus (Government),1171,379,1550
TAMIL NADU,2010,Bus (Private),845,158,1003
TAMIL NADU,2010,Tempo/Vans (Government),17,2,19
TAMIL NADU,2010,Tempo/Vans (Private),1205,272,1477
TAMIL NADU,2010,Jeep (Government),10,0,10
TAMIL NADU,2010,Jeep (Private),166,21,187
TAMIL NADU,2010,Car (Government),48,8,56
TAMIL NADU,2010,Car (Private),1608,294,1902
TAMIL NADU,2010,Three Wheeler,388,86,474
TAMIL NADU,2010,Two Wheeler,3428,407,3835
TAMIL NADU,2010,Bicycle,273,14,287
TAMIL NADU,2010,Pedestrian,842,251,1093
TAMIL NADU,2010,Others (Please Specify),367,44,411
TAMIL NADU,2010,Total Deaths (Persons),12955,2454,15409
TAMIL NADU,2010,Total Truck/Lorry,2587,518,3105
TAMIL NADU,2010,Total Bus,2016,537,2553
TAMIL NADU,2010,Total Tempo/Vans,1222,274,1496
TAMIL NADU,2010,Total Jeep,176,21,197
TAMIL NADU,2010,Total Car,1656,302,1958
TAMIL NADU,2011,Truck/Lorry (Government),12,4,16
TAMIL NADU,2011,Truck/Lorry (Private),2656,436,3092
TAMIL NADU,2011,Bus (Government),1144,173,1317
TAMIL NADU,2011,Bus (Private),817,182,999
TAMIL NADU,2011,Tempo/Vans (Government),1,4,5
TAMIL NADU,2011,Tempo/Vans (Private),985,234,1219
TAMIL NADU,2011,Jeep (Government),7,0,7
TAMIL NADU,2011,Jeep (Private),219,54,273
TAMIL NADU,2011,Car (Government),139,24,163
TAMIL NADU,2011,Car (Private),1677,273,1950
TAMIL NADU,2011,Three Wheeler,347,84,431
TAMIL NADU,2011,Two Wheeler,3488,374,3862
TAMIL NADU,2011,Bicycle,322,19,341
TAMIL NADU,2011,Pedestrian,833,215,1048
TAMIL NADU,2011,Others (Please Specify),508,191,699
TAMIL NADU,2011,Total Deaths (Persons),13155,2267,15422
TAMIL NADU,2011,Total Truck/Lorry,2668,440,3108
TAMIL NADU,2011,Total Bus,1961,355,2316
TAMIL NADU,2011,Total Tempo/Vans,986,238,1224
TAMIL NADU,2011,Total Jeep,226,54,280
TAMIL NADU,2011,Total Car,1816,297,2113
TAMIL NADU,2012,Truck/Lorry (Government),8,6,14
TAMIL NADU,2012,Truck/Lorry (Private),2617,396,3013
TAMIL NADU,2012,Bus (Government),1131,149,1280
TAMIL NADU,2012,Bus (Private),681,235,916
TAMIL NADU,2012,Tempo/Vans (Government),7,1,8
TAMIL NADU,2012,Tempo/Vans (Private),861,186,1047
TAMIL NADU,2012,Jeep (Government),3,16,19
TAMIL NADU,2012,Jeep (Private),245,60,305
TAMIL NADU,2012,Car (Government),103,34,137
TAMIL NADU,2012,Car (Private),2148,246,2394
TAMIL NADU,2012,Three Wheeler,318,72,390
TAMIL NADU,2012,Two Wheeler,3997,469,4466
TAMIL NADU,2012,Bicycle,532,27,559
TAMIL NADU,2012,Pedestrian,196,538,734
TAMIL NADU,2012,Others (Please Specify),650,243,893
TAMIL NADU,2012,Total Deaths (Persons),13497,2678,16175
TAMIL NADU,2012,Total Truck/Lorry,2625,402,3027
TAMIL NADU,2012,Total Bus,1812,384,2196
TAMIL NADU,2012,Total Tempo/Vans,868,187,1055
TAMIL NADU,2012,Total Jeep,248,76,324
TAMIL NADU,2012,Total Car,2251,280,2531
TRIPURA,2001,Truck/Lorry (Government),0,0,0
TRIPURA,2001,Truck/Lorry (Private),34,6,40
TRIPURA,2001,Bus (Government),0,0,0
TRIPURA,2001,Bus (Private),16,4,20
TRIPURA,2001,Tempo/Vans (Government),0,0,0
TRIPURA,2001,Tempo/Vans (Private),2,1,3
TRIPURA,2001,Jeep (Government),0,0,0
TRIPURA,2001,Jeep (Private),85,12,97
TRIPURA,2001,Car (Government),0,0,0
TRIPURA,2001,Car (Private),0,0,0
TRIPURA,2001,Three Wheeler,10,1,11
TRIPURA,2001,Two Wheeler,4,0,4
TRIPURA,2001,Bicycle,0,0,0
TRIPURA,2001,Pedestrian,0,0,0
TRIPURA,2001,Others (Please Specify),0,0,0
TRIPURA,2001,Total Deaths (Persons),151,24,175
TRIPURA,2001,Total Truck/Lorry,34,6,40
TRIPURA,2001,Total Bus,16,4,20
TRIPURA,2001,Total Tempo/Vans,2,1,3
TRIPURA,2001,Total Jeep,85,12,97
TRIPURA,2001,Total Car,0,0,0
TRIPURA,2002,Truck/Lorry (Government),1,0,1
TRIPURA,2002,Truck/Lorry (Private),29,3,32
TRIPURA,2002,Bus (Government),2,1,3
TRIPURA,2002,Bus (Private),16,2,18
TRIPURA,2002,Tempo/Vans (Government),0,0,0
TRIPURA,2002,Tempo/Vans (Private),4,1,5
TRIPURA,2002,Jeep (Government),1,0,1
TRIPURA,2002,Jeep (Private),19,29,48
TRIPURA,2002,Car (Government),1,1,2
TRIPURA,2002,Car (Private),2,0,2
TRIPURA,2002,Three Wheeler,5,1,6
TRIPURA,2002,Two Wheeler,5,2,7
TRIPURA,2002,Bicycle,4,0,4
TRIPURA,2002,Pedestrian,16,2,18
TRIPURA,2002,Others (Please Specify),6,4,10
TRIPURA,2002,Total Deaths (Persons),111,46,157
TRIPURA,2002,Total Truck/Lorry,30,3,33
TRIPURA,2002,Total Bus,18,3,21
TRIPURA,2002,Total Tempo/Vans,4,1,5
TRIPURA,2002,Total Jeep,20,29,49
TRIPURA,2002,Total Car,3,1,4
TRIPURA,2003,Truck/Lorry (Government),0,0,0
TRIPURA,2003,Truck/Lorry (Private),19,6,25
TRIPURA,2003,Bus (Government),0,0,0
TRIPURA,2003,Bus (Private),15,5,20
TRIPURA,2003,Tempo/Vans (Government),0,0,0
TRIPURA,2003,Tempo/Vans (Private),0,0,0
TRIPURA,2003,Jeep (Government),0,0,0
TRIPURA,2003,Jeep (Private),20,5,25
TRIPURA,2003,Car (Government),0,0,0
TRIPURA,2003,Car (Private),20,5,25
TRIPURA,2003,Three Wheeler,0,0,0
TRIPURA,2003,Two Wheeler,26,2,28
TRIPURA,2003,Bicycle,0,0,0
TRIPURA,2003,Pedestrian,0,0,0
TRIPURA,2003,Others (Please Specify),29,16,45
TRIPURA,2003,Total Deaths (Persons),129,39,168
TRIPURA,2003,Total Truck/Lorry,19,6,25
TRIPURA,2003,Total Bus,15,5,20
TRIPURA,2003,Total Tempo/Vans,0,0,0
TRIPURA,2003,Total Jeep,20,5,25
TRIPURA,2003,Total Car,20,5,25
TRIPURA,2004,Truck/Lorry (Government),0,0,0
TRIPURA,2004,Truck/Lorry (Private),21,7,28
TRIPURA,2004,Bus (Government),0,0,0
TRIPURA,2004,Bus (Private),13,5,18
TRIPURA,2004,Tempo/Vans (Government),0,0,0
TRIPURA,2004,Tempo/Vans (Private),15,3,18
TRIPURA,2004,Jeep (Government),1,2,3
TRIPURA,2004,Jeep (Private),46,14,60
TRIPURA,2004,Car (Government),0,0,0
TRIPURA,2004,Car (Private),6,3,9
TRIPURA,2004,Three Wheeler,3,0,3
TRIPURA,2004,Two Wheeler,2,0,2
TRIPURA,2004,Bicycle,1,0,1
TRIPURA,2004,Pedestrian,0,0,0
TRIPURA,2004,Others (Please Specify),16,21,37
TRIPURA,2004,Total Deaths (Persons),124,55,179
TRIPURA,2004,Total Truck/Lorry,21,7,28
TRIPURA,2004,Total Bus,13,5,18
TRIPURA,2004,Total Tempo/Vans,15,3,18
TRIPURA,2004,Total Jeep,47,16,63
TRIPURA,2004,Total Car,6,3,9
TRIPURA,2005,Truck/Lorry (Government),1,0,1
TRIPURA,2005,Truck/Lorry (Private),36,4,40
TRIPURA,2005,Bus (Government),2,1,3
TRIPURA,2005,Bus (Private),14,4,18
TRIPURA,2005,Tempo/Vans (Government),0,0,0
TRIPURA,2005,Tempo/Vans (Private),9,3,12
TRIPURA,2005,Jeep (Government),2,1,3
TRIPURA,2005,Jeep (Private),39,6,45
TRIPURA,2005,Car (Government),0,0,0
TRIPURA,2005,Car (Private),5,4,9
TRIPURA,2005,Three Wheeler,12,1,13
TRIPURA,2005,Two Wheeler,7,2,9
TRIPURA,2005,Bicycle,1,1,2
TRIPURA,2005,Pedestrian,0,0,0
TRIPURA,2005,Others (Please Specify),30,19,49
TRIPURA,2005,Total Deaths (Persons),158,46,204
TRIPURA,2005,Total Truck/Lorry,37,4,41
TRIPURA,2005,Total Bus,16,5,21
TRIPURA,2005,Total Tempo/Vans,9,3,12
TRIPURA,2005,Total Jeep,41,7,48
TRIPURA,2005,Total Car,5,4,9
TRIPURA,2006,Truck/Lorry (Government),0,0,0
TRIPURA,2006,Truck/Lorry (Private),26,1,27
TRIPURA,2006,Bus (Government),0,0,0
TRIPURA,2006,Bus (Private),2,0,2
TRIPURA,2006,Tempo/Vans (Government),0,0,0
TRIPURA,2006,Tempo/Vans (Private),0,0,0
TRIPURA,2006,Jeep (Government),0,0,0
TRIPURA,2006,Jeep (Private),56,18,74
TRIPURA,2006,Car (Government),0,0,0
TRIPURA,2006,Car (Private),4,1,5
TRIPURA,2006,Three Wheeler,32,16,48
TRIPURA,2006,Two Wheeler,7,3,10
TRIPURA,2006,Bicycle,1,0,1
TRIPURA,2006,Pedestrian,5,2,7
TRIPURA,2006,Others (Please Specify),17,5,22
TRIPURA,2006,Total Deaths (Persons),150,46,196
TRIPURA,2006,Total Truck/Lorry,26,1,27
TRIPURA,2006,Total Bus,2,0,2
TRIPURA,2006,Total Tempo/Vans,0,0,0
TRIPURA,2006,Total Jeep,56,18,74
TRIPURA,2006,Total Car,4,1,5
TRIPURA,2007,Truck/Lorry (Government),4,0,4
TRIPURA,2007,Truck/Lorry (Private),37,2,39
TRIPURA,2007,Bus (Government),0,0,0
TRIPURA,2007,Bus (Private),22,8,30
TRIPURA,2007,Tempo/Vans (Government),0,0,0
TRIPURA,2007,Tempo/Vans (Private),3,0,3
TRIPURA,2007,Jeep (Government),2,0,2
TRIPURA,2007,Jeep (Private),36,14,50
TRIPURA,2007,Car (Government),0,1,1
TRIPURA,2007,Car (Private),19,2,21
TRIPURA,2007,Three Wheeler,19,1,20
TRIPURA,2007,Two Wheeler,19,1,20
TRIPURA,2007,Bicycle,0,0,0
TRIPURA,2007,Pedestrian,11,3,14
TRIPURA,2007,Others (Please Specify),19,0,19
TRIPURA,2007,Total Deaths (Persons),191,32,223
TRIPURA,2007,Total Truck/Lorry,41,2,43
TRIPURA,2007,Total Bus,22,8,30
TRIPURA,2007,Total Tempo/Vans,3,0,3
TRIPURA,2007,Total Jeep,38,14,52
TRIPURA,2007,Total Car,19,3,22
TRIPURA,2008,Truck/Lorry (Government),0,0,0
TRIPURA,2008,Truck/Lorry (Private),54,7,61
TRIPURA,2008,Bus (Government),0,0,0
TRIPURA,2008,Bus (Private),9,1,10
TRIPURA,2008,Tempo/Vans (Government),0,0,0
TRIPURA,2008,Tempo/Vans (Private),5,1,6
TRIPURA,2008,Jeep (Government),0,0,0
TRIPURA,2008,Jeep (Private),45,8,53
TRIPURA,2008,Car (Government),0,0,0
TRIPURA,2008,Car (Private),5,1,6
TRIPURA,2008,Three Wheeler,20,3,23
TRIPURA,2008,Two Wheeler,21,4,25
TRIPURA,2008,Bicycle,0,0,0
TRIPURA,2008,Pedestrian,10,0,10
TRIPURA,2008,Others (Please Specify),22,5,27
TRIPURA,2008,Total Deaths (Persons),191,30,221
TRIPURA,2008,Total Truck/Lorry,54,7,61
TRIPURA,2008,Total Bus,9,1,10
TRIPURA,2008,Total Tempo/Vans,5,1,6
TRIPURA,2008,Total Jeep,45,8,53
TRIPURA,2008,Total Car,5,1,6
TRIPURA,2009,Truck/Lorry (Government),0,0,0
TRIPURA,2009,Truck/Lorry (Private),27,5,32
TRIPURA,2009,Bus (Government),1,1,2
TRIPURA,2009,Bus (Private),9,3,12
TRIPURA,2009,Tempo/Vans (Government),0,0,0
TRIPURA,2009,Tempo/Vans (Private),14,4,18
TRIPURA,2009,Jeep (Government),0,0,0
TRIPURA,2009,Jeep (Private),19,9,28
TRIPURA,2009,Car (Government),1,0,1
TRIPURA,2009,Car (Private),15,3,18
TRIPURA,2009,Three Wheeler,15,3,18
TRIPURA,2009,Two Wheeler,29,3,32
TRIPURA,2009,Bicycle,8,0,8
TRIPURA,2009,Pedestrian,39,20,59
TRIPURA,2009,Others (Please Specify),0,1,1
TRIPURA,2009,Total Deaths (Persons),177,52,229
TRIPURA,2009,Total Truck/Lorry,27,5,32
TRIPURA,2009,Total Bus,10,4,14
TRIPURA,2009,Total Tempo/Vans,14,4,18
TRIPURA,2009,Total Jeep,19,9,28
TRIPURA,2009,Total Car,16,3,19
TRIPURA,2010,Truck/Lorry (Government),0,0,0
TRIPURA,2010,Truck/Lorry (Private),44,4,48
TRIPURA,2010,Bus (Government),0,0,0
TRIPURA,2010,Bus (Private),15,2,17
TRIPURA,2010,Tempo/Vans (Government),0,0,0
TRIPURA,2010,Tempo/Vans (Private),21,5,26
TRIPURA,2010,Jeep (Government),0,0,0
TRIPURA,2010,Jeep (Private),45,10,55
TRIPURA,2010,Car (Government),0,0,0
TRIPURA,2010,Car (Private),9,2,11
TRIPURA,2010,Three Wheeler,7,0,7
TRIPURA,2010,Two Wheeler,38,5,43
TRIPURA,2010,Bicycle,9,0,9
TRIPURA,2010,Pedestrian,7,3,10
TRIPURA,2010,Others (Please Specify),10,0,10
TRIPURA,2010,Total Deaths (Persons),205,31,236
TRIPURA,2010,Total Truck/Lorry,44,4,48
TRIPURA,2010,Total Bus,15,2,17
TRIPURA,2010,Total Tempo/Vans,21,5,26
TRIPURA,2010,Total Jeep,45,10,55
TRIPURA,2010,Total Car,9,2,11
TRIPURA,2011,Truck/Lorry (Government),1,0,1
TRIPURA,2011,Truck/Lorry (Private),47,1,48
TRIPURA,2011,Bus (Government),0,0,0
TRIPURA,2011,Bus (Private),20,3,23
TRIPURA,2011,Tempo/Vans (Government),0,0,0
TRIPURA,2011,Tempo/Vans (Private),17,6,23
TRIPURA,2011,Jeep (Government),5,0,5
TRIPURA,2011,Jeep (Private),26,14,40
TRIPURA,2011,Car (Government),0,0,0
TRIPURA,2011,Car (Private),15,0,15
TRIPURA,2011,Three Wheeler,14,2,16
TRIPURA,2011,Two Wheeler,38,9,47
TRIPURA,2011,Bicycle,6,0,6
TRIPURA,2011,Pedestrian,9,4,13
TRIPURA,2011,Others (Please Specify),7,1,8
TRIPURA,2011,Total Deaths (Persons),205,40,245
TRIPURA,2011,Total Truck/Lorry,48,1,49
TRIPURA,2011,Total Bus,20,3,23
TRIPURA,2011,Total Tempo/Vans,17,6,23
TRIPURA,2011,Total Jeep,31,14,45
TRIPURA,2011,Total Car,15,0,15
TRIPURA,2012,Truck/Lorry (Government),0,0,0
TRIPURA,2012,Truck/Lorry (Private),0,0,0
TRIPURA,2012,Bus (Government),8,0,8
TRIPURA,2012,Bus (Private),6,3,9
TRIPURA,2012,Tempo/Vans (Government),0,0,0
TRIPURA,2012,Tempo/Vans (Private),6,3,9
TRIPURA,2012,Jeep (Government),1,0,1
TRIPURA,2012,Jeep (Private),39,10,49
TRIPURA,2012,Car (Government),1,0,1
TRIPURA,2012,Car (Private),10,4,14
TRIPURA,2012,Three Wheeler,18,3,21
TRIPURA,2012,Two Wheeler,38,8,46
TRIPURA,2012,Bicycle,2,1,3
TRIPURA,2012,Pedestrian,22,3,25
TRIPURA,2012,Others (Please Specify),79,7,86
TRIPURA,2012,Total Deaths (Persons),230,42,272
TRIPURA,2012,Total Truck/Lorry,0,0,0
TRIPURA,2012,Total Bus,14,3,17
TRIPURA,2012,Total Tempo/Vans,6,3,9
TRIPURA,2012,Total Jeep,40,10,50
TRIPURA,2012,Total Car,11,4,15
UTTAR PRADESH,2001,Truck/Lorry (Government),100,33,133
UTTAR PRADESH,2001,Truck/Lorry (Private),1792,215,2007
UTTAR PRADESH,2001,Bus (Government),400,67,467
UTTAR PRADESH,2001,Bus (Private),696,99,795
UTTAR PRADESH,2001,Tempo/Vans (Government),9,4,13
UTTAR PRADESH,2001,Tempo/Vans (Private),635,111,746
UTTAR PRADESH,2001,Jeep (Government),21,5,26
UTTAR PRADESH,2001,Jeep (Private),1283,139,1422
UTTAR PRADESH,2001,Car (Government),35,13,48
UTTAR PRADESH,2001,Car (Private),531,113,644
UTTAR PRADESH,2001,Three Wheeler,362,77,439
UTTAR PRADESH,2001,Two Wheeler,683,80,763
UTTAR PRADESH,2001,Bicycle,379,24,403
UTTAR PRADESH,2001,Pedestrian,718,242,960
UTTAR PRADESH,2001,Others (Please Specify),284,46,330
UTTAR PRADESH,2001,Total Deaths (Persons),7928,1268,9196
UTTAR PRADESH,2001,Total Truck/Lorry,1892,248,2140
UTTAR PRADESH,2001,Total Bus,1096,166,1262
UTTAR PRADESH,2001,Total Tempo/Vans,644,115,759
UTTAR PRADESH,2001,Total Jeep,1304,144,1448
UTTAR PRADESH,2001,Total Car,566,126,692
UTTAR PRADESH,2002,Truck/Lorry (Government),158,63,221
UTTAR PRADESH,2002,Truck/Lorry (Private),2040,164,2204
UTTAR PRADESH,2002,Bus (Government),208,25,233
UTTAR PRADESH,2002,Bus (Private),778,136,914
UTTAR PRADESH,2002,Tempo/Vans (Government),47,3,50
UTTAR PRADESH,2002,Tempo/Vans (Private),636,100,736
UTTAR PRADESH,2002,Jeep (Government),56,9,65
UTTAR PRADESH,2002,Jeep (Private),1166,194,1360
UTTAR PRADESH,2002,Car (Government),27,6,33
UTTAR PRADESH,2002,Car (Private),550,114,664
UTTAR PRADESH,2002,Three Wheeler,298,57,355
UTTAR PRADESH,2002,Two Wheeler,861,178,1039
UTTAR PRADESH,2002,Bicycle,394,44,438
UTTAR PRADESH,2002,Pedestrian,614,154,768
UTTAR PRADESH,2002,Others (Please Specify),308,57,365
UTTAR PRADESH,2002,Total Deaths (Persons),8141,1304,9445
UTTAR PRADESH,2002,Total Truck/Lorry,2198,227,2425
UTTAR PRADESH,2002,Total Bus,986,161,1147
UTTAR PRADESH,2002,Total Tempo/Vans,683,103,786
UTTAR PRADESH,2002,Total Jeep,1222,203,1425
UTTAR PRADESH,2002,Total Car,577,120,697
UTTAR PRADESH,2003,Truck/Lorry (Government),95,8,103
UTTAR PRADESH,2003,Truck/Lorry (Private),1373,202,1575
UTTAR PRADESH,2003,Bus (Government),52,9,61
UTTAR PRADESH,2003,Bus (Private),729,168,897
UTTAR PRADESH,2003,Tempo/Vans (Government),12,2,14
UTTAR PRADESH,2003,Tempo/Vans (Private),472,78,550
UTTAR PRADESH,2003,Jeep (Government),8,1,9
UTTAR PRADESH,2003,Jeep (Private),967,204,1171
UTTAR PRADESH,2003,Car (Government),9,2,11
UTTAR PRADESH,2003,Car (Private),392,69,461
UTTAR PRADESH,2003,Three Wheeler,296,52,348
UTTAR PRADESH,2003,Two Wheeler,1071,157,1228
UTTAR PRADESH,2003,Bicycle,494,15,509
UTTAR PRADESH,2003,Pedestrian,631,90,721
UTTAR PRADESH,2003,Others (Please Specify),249,30,279
UTTAR PRADESH,2003,Total Deaths (Persons),6850,1087,7937
UTTAR PRADESH,2003,Total Truck/Lorry,1468,210,1678
UTTAR PRADESH,2003,Total Bus,781,177,958
UTTAR PRADESH,2003,Total Tempo/Vans,484,80,564
UTTAR PRADESH,2003,Total Jeep,975,205,1180
UTTAR PRADESH,2003,Total Car,401,71,472
UTTAR PRADESH,2004,Truck/Lorry (Government),59,15,74
UTTAR PRADESH,2004,Truck/Lorry (Private),2124,345,2469
UTTAR PRADESH,2004,Bus (Government),405,100,505
UTTAR PRADESH,2004,Bus (Private),404,76,480
UTTAR PRADESH,2004,Tempo/Vans (Government),19,4,23
UTTAR PRADESH,2004,Tempo/Vans (Private),714,142,856
UTTAR PRADESH,2004,Jeep (Government),26,5,31
UTTAR PRADESH,2004,Jeep (Private),1093,246,1339
UTTAR PRADESH,2004,Car (Government),15,3,18
UTTAR PRADESH,2004,Car (Private),507,117,624
UTTAR PRADESH,2004,Three Wheeler,315,78,393
UTTAR PRADESH,2004,Two Wheeler,1304,235,1539
UTTAR PRADESH,2004,Bicycle,631,49,680
UTTAR PRADESH,2004,Pedestrian,681,195,876
UTTAR PRADESH,2004,Others (Please Specify),229,46,275
UTTAR PRADESH,2004,Total Deaths (Persons),8526,1656,10182
UTTAR PRADESH,2004,Total Truck/Lorry,2183,360,2543
UTTAR PRADESH,2004,Total Bus,809,176,985
UTTAR PRADESH,2004,Total Tempo/Vans,733,146,879
UTTAR PRADESH,2004,Total Jeep,1119,251,1370
UTTAR PRADESH,2004,Total Car,522,120,642
UTTAR PRADESH,2005,Truck/Lorry (Government),123,9,132
UTTAR PRADESH,2005,Truck/Lorry (Private),1833,286,2119
UTTAR PRADESH,2005,Bus (Government),147,33,180
UTTAR PRADESH,2005,Bus (Private),748,117,865
UTTAR PRADESH,2005,Tempo/Vans (Government),29,0,29
UTTAR PRADESH,2005,Tempo/Vans (Private),679,154,833
UTTAR PRADESH,2005,Jeep (Government),39,7,46
UTTAR PRADESH,2005,Jeep (Private),1147,178,1325
UTTAR PRADESH,2005,Car (Government),17,3,20
UTTAR PRADESH,2005,Car (Private),598,102,700
UTTAR PRADESH,2005,Three Wheeler,356,62,418
UTTAR PRADESH,2005,Two Wheeler,1302,271,1573
UTTAR PRADESH,2005,Bicycle,583,60,643
UTTAR PRADESH,2005,Pedestrian,583,136,719
UTTAR PRADESH,2005,Others (Please Specify),202,56,258
UTTAR PRADESH,2005,Total Deaths (Persons),8386,1474,9860
UTTAR PRADESH,2005,Total Truck/Lorry,1956,295,2251
UTTAR PRADESH,2005,Total Bus,895,150,1045
UTTAR PRADESH,2005,Total Tempo/Vans,708,154,862
UTTAR PRADESH,2005,Total Jeep,1186,185,1371
UTTAR PRADESH,2005,Total Car,615,105,720
UTTAR PRADESH,2006,Truck/Lorry (Government),52,12,64
UTTAR PRADESH,2006,Truck/Lorry (Private),2301,394,2695
UTTAR PRADESH,2006,Bus (Government),637,114,751
UTTAR PRADESH,2006,Bus (Private),422,72,494
UTTAR PRADESH,2006,Tempo/Vans (Government),29,10,39
UTTAR PRADESH,2006,Tempo/Vans (Private),668,149,817
UTTAR PRADESH,2006,Jeep (Government),24,6,30
UTTAR PRADESH,2006,Jeep (Private),1283,204,1487
UTTAR PRADESH,2006,Car (Government),36,24,60
UTTAR PRADESH,2006,Car (Private),562,653,1215
UTTAR PRADESH,2006,Three Wheeler,398,63,461
UTTAR PRADESH,2006,Two Wheeler,1482,242,1724
UTTAR PRADESH,2006,Bicycle,554,63,617
UTTAR PRADESH,2006,Pedestrian,614,126,740
UTTAR PRADESH,2006,Others (Please Specify),276,50,326
UTTAR PRADESH,2006,Total Deaths (Persons),9338,2182,11520
UTTAR PRADESH,2006,Total Truck/Lorry,2353,406,2759
UTTAR PRADESH,2006,Total Bus,1059,186,1245
UTTAR PRADESH,2006,Total Tempo/Vans,697,159,856
UTTAR PRADESH,2006,Total Jeep,1307,210,1517
UTTAR PRADESH,2006,Total Car,598,677,1275
UTTAR PRADESH,2007,Truck/Lorry (Government),163,41,204
UTTAR PRADESH,2007,Truck/Lorry (Private),2235,319,2554
UTTAR PRADESH,2007,Bus (Government),396,50,446
UTTAR PRADESH,2007,Bus (Private),766,117,883
UTTAR PRADESH,2007,Tempo/Vans (Government),76,28,104
UTTAR PRADESH,2007,Tempo/Vans (Private),783,142,925
UTTAR PRADESH,2007,Jeep (Government),111,16,127
UTTAR PRADESH,2007,Jeep (Private),1323,219,1542
UTTAR PRADESH,2007,Car (Government),36,6,42
UTTAR PRADESH,2007,Car (Private),723,162,885
UTTAR PRADESH,2007,Three Wheeler,504,78,582
UTTAR PRADESH,2007,Two Wheeler,1814,264,2078
UTTAR PRADESH,2007,Bicycle,669,48,717
UTTAR PRADESH,2007,Pedestrian,818,119,937
UTTAR PRADESH,2007,Others (Please Specify),431,98,529
UTTAR PRADESH,2007,Total Deaths (Persons),10848,1707,12555
UTTAR PRADESH,2007,Total Truck/Lorry,2398,360,2758
UTTAR PRADESH,2007,Total Bus,1162,167,1329
UTTAR PRADESH,2007,Total Tempo/Vans,859,170,1029
UTTAR PRADESH,2007,Total Jeep,1434,235,1669
UTTAR PRADESH,2007,Total Car,759,168,927
UTTAR PRADESH,2008,Truck/Lorry (Government),134,25,159
UTTAR PRADESH,2008,Truck/Lorry (Private),2365,306,2671
UTTAR PRADESH,2008,Bus (Government),372,59,431
UTTAR PRADESH,2008,Bus (Private),558,116,674
UTTAR PRADESH,2008,Tempo/Vans (Government),14,2,16
UTTAR PRADESH,2008,Tempo/Vans (Private),849,144,993
UTTAR PRADESH,2008,Jeep (Government),21,11,32
UTTAR PRADESH,2008,Jeep (Private),1270,206,1476
UTTAR PRADESH,2008,Car (Government),28,8,36
UTTAR PRADESH,2008,Car (Private),929,139,1068
UTTAR PRADESH,2008,Three Wheeler,490,87,577
UTTAR PRADESH,2008,Two Wheeler,1779,341,2120
UTTAR PRADESH,2008,Bicycle,597,67,664
UTTAR PRADESH,2008,Pedestrian,761,138,899
UTTAR PRADESH,2008,Others (Please Specify),213,44,257
UTTAR PRADESH,2008,Total Deaths (Persons),10380,1693,12073
UTTAR PRADESH,2008,Total Truck/Lorry,2499,331,2830
UTTAR PRADESH,2008,Total Bus,930,175,1105
UTTAR PRADESH,2008,Total Tempo/Vans,863,146,1009
UTTAR PRADESH,2008,Total Jeep,1291,217,1508
UTTAR PRADESH,2008,Total Car,957,147,1104
UTTAR PRADESH,2009,Truck/Lorry (Government),75,9,84
UTTAR PRADESH,2009,Truck/Lorry (Private),2413,285,2698
UTTAR PRADESH,2009,Bus (Government),199,64,263
UTTAR PRADESH,2009,Bus (Private),957,150,1107
UTTAR PRADESH,2009,Tempo/Vans (Government),23,0,23
UTTAR PRADESH,2009,Tempo/Vans (Private),914,213,1127
UTTAR PRADESH,2009,Jeep (Government),25,3,28
UTTAR PRADESH,2009,Jeep (Private),1463,247,1710
UTTAR PRADESH,2009,Car (Government),10,2,12
UTTAR PRADESH,2009,Car (Private),1138,149,1287
UTTAR PRADESH,2009,Three Wheeler,551,88,639
UTTAR PRADESH,2009,Two Wheeler,2428,378,2806
UTTAR PRADESH,2009,Bicycle,732,72,804
UTTAR PRADESH,2009,Pedestrian,1083,245,1328
UTTAR PRADESH,2009,Others (Please Specify),826,87,913
UTTAR PRADESH,2009,Total Deaths (Persons),12837,1992,14829
UTTAR PRADESH,2009,Total Truck/Lorry,2488,294,2782
UTTAR PRADESH,2009,Total Bus,1156,214,1370
UTTAR PRADESH,2009,Total Tempo/Vans,937,213,1150
UTTAR PRADESH,2009,Total Jeep,1488,250,1738
UTTAR PRADESH,2009,Total Car,1148,151,1299
UTTAR PRADESH,2010,Truck/Lorry (Government),135,8,143
UTTAR PRADESH,2010,Truck/Lorry (Private),2825,432,3257
UTTAR PRADESH,2010,Bus (Government),235,67,302
UTTAR PRADESH,2010,Bus (Private),1039,223,1262
UTTAR PRADESH,2010,Tempo/Vans (Government),37,4,41
UTTAR PRADESH,2010,Tempo/Vans (Private),1219,253,1472
UTTAR PRADESH,2010,Jeep (Government),43,11,54
UTTAR PRADESH,2010,Jeep (Private),1341,255,1596
UTTAR PRADESH,2010,Car (Government),41,1,42
UTTAR PRADESH,2010,Car (Private),1057,212,1269
UTTAR PRADESH,2010,Three Wheeler,579,115,694
UTTAR PRADESH,2010,Two Wheeler,2198,361,2559
UTTAR PRADESH,2010,Bicycle,692,87,779
UTTAR PRADESH,2010,Pedestrian,832,179,1011
UTTAR PRADESH,2010,Others (Please Specify),540,78,618
UTTAR PRADESH,2010,Total Deaths (Persons),12813,2286,15099
UTTAR PRADESH,2010,Total Truck/Lorry,2960,440,3400
UTTAR PRADESH,2010,Total Bus,1274,290,1564
UTTAR PRADESH,2010,Total Tempo/Vans,1256,257,1513
UTTAR PRADESH,2010,Total Jeep,1384,266,1650
UTTAR PRADESH,2010,Total Car,1098,213,1311
UTTAR PRADESH,2011,Truck/Lorry (Government),57,12,69
UTTAR PRADESH,2011,Truck/Lorry (Private),2699,322,3021
UTTAR PRADESH,2011,Bus (Government),270,67,337
UTTAR PRADESH,2011,Bus (Private),835,195,1030
UTTAR PRADESH,2011,Tempo/Vans (Government),43,27,70
UTTAR PRADESH,2011,Tempo/Vans (Private),1053,217,1270
UTTAR PRADESH,2011,Jeep (Government),23,4,27
UTTAR PRADESH,2011,Jeep (Private),1062,224,1286
UTTAR PRADESH,2011,Car (Government),20,3,23
UTTAR PRADESH,2011,Car (Private),1149,231,1380
UTTAR PRADESH,2011,Three Wheeler,682,148,830
UTTAR PRADESH,2011,Two Wheeler,2459,361,2820
UTTAR PRADESH,2011,Bicycle,701,110,811
UTTAR PRADESH,2011,Pedestrian,1118,297,1415
UTTAR PRADESH,2011,Others (Please Specify),502,105,607
UTTAR PRADESH,2011,Total Deaths (Persons),12673,2323,14996
UTTAR PRADESH,2011,Total Truck/Lorry,2756,334,3090
UTTAR PRADESH,2011,Total Bus,1105,262,1367
UTTAR PRADESH,2011,Total Tempo/Vans,1096,244,1340
UTTAR PRADESH,2011,Total Jeep,1085,228,1313
UTTAR PRADESH,2011,Total Car,1169,234,1403
UTTAR PRADESH,2012,Truck/Lorry (Government),192,27,219
UTTAR PRADESH,2012,Truck/Lorry (Private),2968,384,3352
UTTAR PRADESH,2012,Bus (Government),593,107,700
UTTAR PRADESH,2012,Bus (Private),894,190,1084
UTTAR PRADESH,2012,Tempo/Vans (Government),19,8,27
UTTAR PRADESH,2012,Tempo/Vans (Private),907,261,1168
UTTAR PRADESH,2012,Jeep (Government),88,5,93
UTTAR PRADESH,2012,Jeep (Private),1128,262,1390
UTTAR PRADESH,2012,Car (Government),60,7,67
UTTAR PRADESH,2012,Car (Private),1078,184,1262
UTTAR PRADESH,2012,Three Wheeler,758,155,913
UTTAR PRADESH,2012,Two Wheeler,2328,360,2688
UTTAR PRADESH,2012,Bicycle,559,52,611
UTTAR PRADESH,2012,Pedestrian,672,126,798
UTTAR PRADESH,2012,Others (Please Specify),643,94,737
UTTAR PRADESH,2012,Total Deaths (Persons),12887,2222,15109
UTTAR PRADESH,2012,Total Truck/Lorry,3160,411,3571
UTTAR PRADESH,2012,Total Bus,1487,297,1784
UTTAR PRADESH,2012,Total Tempo/Vans,926,269,1195
UTTAR PRADESH,2012,Total Jeep,1216,267,1483
UTTAR PRADESH,2012,Total Car,1138,191,1329
UTTARAKHAND,2001,Truck/Lorry (Government),8,1,9
UTTARAKHAND,2001,Truck/Lorry (Private),98,12,110
UTTARAKHAND,2001,Bus (Government),0,0,0
UTTARAKHAND,2001,Bus (Private),111,38,149
UTTARAKHAND,2001,Tempo/Vans (Government),0,0,0
UTTARAKHAND,2001,Tempo/Vans (Private),42,14,56
UTTARAKHAND,2001,Jeep (Government),1,2,3
UTTARAKHAND,2001,Jeep (Private),110,34,144
UTTARAKHAND,2001,Car (Government),0,0,0
UTTARAKHAND,2001,Car (Private),39,8,47
UTTARAKHAND,2001,Three Wheeler,51,13,64
UTTARAKHAND,2001,Two Wheeler,78,10,88
UTTARAKHAND,2001,Bicycle,7,0,7
UTTARAKHAND,2001,Pedestrian,30,6,36
UTTARAKHAND,2001,Others (Please Specify),48,20,68
UTTARAKHAND,2001,Total Deaths (Persons),623,158,781
UTTARAKHAND,2001,Total Truck/Lorry,106,13,119
UTTARAKHAND,2001,Total Bus,111,38,149
UTTARAKHAND,2001,Total Tempo/Vans,42,14,56
UTTARAKHAND,2001,Total Jeep,111,36,147
UTTARAKHAND,2001,Total Car,39,8,47
UTTARAKHAND,2002,Truck/Lorry (Government),15,0,15
UTTARAKHAND,2002,Truck/Lorry (Private),157,4,161
UTTARAKHAND,2002,Bus (Government),0,0,0
UTTARAKHAND,2002,Bus (Private),115,35,150
UTTARAKHAND,2002,Tempo/Vans (Government),1,0,1
UTTARAKHAND,2002,Tempo/Vans (Private),33,5,38
UTTARAKHAND,2002,Jeep (Government),3,3,6
UTTARAKHAND,2002,Jeep (Private),92,10,102
UTTARAKHAND,2002,Car (Government),0,1,1
UTTARAKHAND,2002,Car (Private),36,9,45
UTTARAKHAND,2002,Three Wheeler,14,2,16
UTTARAKHAND,2002,Two Wheeler,56,7,63
UTTARAKHAND,2002,Bicycle,7,0,7
UTTARAKHAND,2002,Pedestrian,38,10,48
UTTARAKHAND,2002,Others (Please Specify),47,5,52
UTTARAKHAND,2002,Total Deaths (Persons),614,91,705
UTTARAKHAND,2002,Total Truck/Lorry,172,4,176
UTTARAKHAND,2002,Total Bus,115,35,150
UTTARAKHAND,2002,Total Tempo/Vans,34,5,39
UTTARAKHAND,2002,Total Jeep,95,13,108
UTTARAKHAND,2002,Total Car,36,10,46
UTTARAKHAND,2003,Truck/Lorry (Government),0,0,0
UTTARAKHAND,2003,Truck/Lorry (Private),149,10,159
UTTARAKHAND,2003,Bus (Government),8,1,9
UTTARAKHAND,2003,Bus (Private),72,24,96
UTTARAKHAND,2003,Tempo/Vans (Government),0,0,0
UTTARAKHAND,2003,Tempo/Vans (Private),25,0,25
UTTARAKHAND,2003,Jeep (Government),1,0,1
UTTARAKHAND,2003,Jeep (Private),132,31,163
UTTARAKHAND,2003,Car (Government),0,0,0
UTTARAKHAND,2003,Car (Private),75,29,104
UTTARAKHAND,2003,Three Wheeler,9,2,11
UTTARAKHAND,2003,Two Wheeler,52,2,54
UTTARAKHAND,2003,Bicycle,4,0,4
UTTARAKHAND,2003,Pedestrian,24,4,28
UTTARAKHAND,2003,Others (Please Specify),56,10,66
UTTARAKHAND,2003,Total Deaths (Persons),607,113,720
UTTARAKHAND,2003,Total Truck/Lorry,149,10,159
UTTARAKHAND,2003,Total Bus,80,25,105
UTTARAKHAND,2003,Total Tempo/Vans,25,0,25
UTTARAKHAND,2003,Total Jeep,133,31,164
UTTARAKHAND,2003,Total Car,75,29,104
UTTARAKHAND,2004,Truck/Lorry (Government),5,0,5
UTTARAKHAND,2004,Truck/Lorry (Private),211,13,224
UTTARAKHAND,2004,Bus (Government),33,6,39
UTTARAKHAND,2004,Bus (Private),170,27,197
UTTARAKHAND,2004,Tempo/Vans (Government),0,0,0
UTTARAKHAND,2004,Tempo/Vans (Private),62,9,71
UTTARAKHAND,2004,Jeep (Government),3,0,3
UTTARAKHAND,2004,Jeep (Private),93,11,104
UTTARAKHAND,2004,Car (Government),1,0,1
UTTARAKHAND,2004,Car (Private),66,10,76
UTTARAKHAND,2004,Three Wheeler,14,1,15
UTTARAKHAND,2004,Two Wheeler,79,5,84
UTTARAKHAND,2004,Bicycle,8,1,9
UTTARAKHAND,2004,Pedestrian,15,4,19
UTTARAKHAND,2004,Others (Please Specify),71,13,84
UTTARAKHAND,2004,Total Deaths (Persons),831,100,931
UTTARAKHAND,2004,Total Truck/Lorry,216,13,229
UTTARAKHAND,2004,Total Bus,203,33,236
UTTARAKHAND,2004,Total Tempo/Vans,62,9,71
UTTARAKHAND,2004,Total Jeep,96,11,107
UTTARAKHAND,2004,Total Car,67,10,77
UTTARAKHAND,2005,Truck/Lorry (Government),6,0,6
UTTARAKHAND,2005,Truck/Lorry (Private),157,22,179
UTTARAKHAND,2005,Bus (Government),8,3,11
UTTARAKHAND,2005,Bus (Private),158,27,185
UTTARAKHAND,2005,Tempo/Vans (Government),0,0,0
UTTARAKHAND,2005,Tempo/Vans (Private),33,4,37
UTTARAKHAND,2005,Jeep (Government),0,1,1
UTTARAKHAND,2005,Jeep (Private),87,22,109
UTTARAKHAND,2005,Car (Government),9,0,9
UTTARAKHAND,2005,Car (Private),79,8,87
UTTARAKHAND,2005,Three Wheeler,34,2,36
UTTARAKHAND,2005,Two Wheeler,55,2,57
UTTARAKHAND,2005,Bicycle,8,0,8
UTTARAKHAND,2005,Pedestrian,29,9,38
UTTARAKHAND,2005,Others (Please Specify),95,11,106
UTTARAKHAND,2005,Total Deaths (Persons),758,111,869
UTTARAKHAND,2005,Total Truck/Lorry,163,22,185
UTTARAKHAND,2005,Total Bus,166,30,196
UTTARAKHAND,2005,Total Tempo/Vans,33,4,37
UTTARAKHAND,2005,Total Jeep,87,23,110
UTTARAKHAND,2005,Total Car,88,8,96
UTTARAKHAND,2006,Truck/Lorry (Government),4,0,4
UTTARAKHAND,2006,Truck/Lorry (Private),207,37,244
UTTARAKHAND,2006,Bus (Government),5,0,5
UTTARAKHAND,2006,Bus (Private),143,33,176
UTTARAKHAND,2006,Tempo/Vans (Government),0,0,0
UTTARAKHAND,2006,Tempo/Vans (Private),35,9,44
UTTARAKHAND,2006,Jeep (Government),0,1,1
UTTARAKHAND,2006,Jeep (Private),81,13,94
UTTARAKHAND,2006,Car (Government),0,0,0
UTTARAKHAND,2006,Car (Private),78,17,95
UTTARAKHAND,2006,Three Wheeler,16,5,21
UTTARAKHAND,2006,Two Wheeler,89,5,94
UTTARAKHAND,2006,Bicycle,9,0,9
UTTARAKHAND,2006,Pedestrian,21,5,26
UTTARAKHAND,2006,Others (Please Specify),134,28,162
UTTARAKHAND,2006,Total Deaths (Persons),822,153,975
UTTARAKHAND,2006,Total Truck/Lorry,211,37,248
UTTARAKHAND,2006,Total Bus,148,33,181
UTTARAKHAND,2006,Total Tempo/Vans,35,9,44
UTTARAKHAND,2006,Total Jeep,81,14,95
UTTARAKHAND,2006,Total Car,78,17,95
UTTARAKHAND,2007,Truck/Lorry (Government),0,0,0
UTTARAKHAND,2007,Truck/Lorry (Private),187,28,215
UTTARAKHAND,2007,Bus (Government),3,0,3
UTTARAKHAND,2007,Bus (Private),142,63,205
UTTARAKHAND,2007,Tempo/Vans (Government),0,0,0
UTTARAKHAND,2007,Tempo/Vans (Private),31,9,40
UTTARAKHAND,2007,Jeep (Government),0,0,0
UTTARAKHAND,2007,Jeep (Private),86,29,115
UTTARAKHAND,2007,Car (Government),0,0,0
UTTARAKHAND,2007,Car (Private),87,25,112
UTTARAKHAND,2007,Three Wheeler,24,8,32
UTTARAKHAND,2007,Two Wheeler,78,4,82
UTTARAKHAND,2007,Bicycle,3,0,3
UTTARAKHAND,2007,Pedestrian,27,2,29
UTTARAKHAND,2007,Others (Please Specify),118,19,137
UTTARAKHAND,2007,Total Deaths (Persons),786,187,973
UTTARAKHAND,2007,Total Truck/Lorry,187,28,215
UTTARAKHAND,2007,Total Bus,145,63,208
UTTARAKHAND,2007,Total Tempo/Vans,31,9,40
UTTARAKHAND,2007,Total Jeep,86,29,115
UTTARAKHAND,2007,Total Car,87,25,112
UTTARAKHAND,2008,Truck/Lorry (Government),10,0,10
UTTARAKHAND,2008,Truck/Lorry (Private),183,21,204
UTTARAKHAND,2008,Bus (Government),24,5,29
UTTARAKHAND,2008,Bus (Private),145,54,199
UTTARAKHAND,2008,Tempo/Vans (Government),2,2,4
UTTARAKHAND,2008,Tempo/Vans (Private),79,14,93
UTTARAKHAND,2008,Jeep (Government),12,2,14
UTTARAKHAND,2008,Jeep (Private),91,21,112
UTTARAKHAND,2008,Car (Government),0,0,0
UTTARAKHAND,2008,Car (Private),77,21,98
UTTARAKHAND,2008,Three Wheeler,38,4,42
UTTARAKHAND,2008,Two Wheeler,84,18,102
UTTARAKHAND,2008,Bicycle,8,1,9
UTTARAKHAND,2008,Pedestrian,40,4,44
UTTARAKHAND,2008,Others (Please Specify),88,19,107
UTTARAKHAND,2008,Total Deaths (Persons),881,186,1067
UTTARAKHAND,2008,Total Truck/Lorry,193,21,214
UTTARAKHAND,2008,Total Bus,169,59,228
UTTARAKHAND,2008,Total Tempo/Vans,81,16,97
UTTARAKHAND,2008,Total Jeep,103,23,126
UTTARAKHAND,2008,Total Car,77,21,98
UTTARAKHAND,2009,Truck/Lorry (Government),1,0,1
UTTARAKHAND,2009,Truck/Lorry (Private),167,13,180
UTTARAKHAND,2009,Bus (Government),0,0,0
UTTARAKHAND,2009,Bus (Private),109,26,135
UTTARAKHAND,2009,Tempo/Vans (Government),0,0,0
UTTARAKHAND,2009,Tempo/Vans (Private),40,5,45
UTTARAKHAND,2009,Jeep (Government),2,0,2
UTTARAKHAND,2009,Jeep (Private),91,16,107
UTTARAKHAND,2009,Car (Government),6,4,10
UTTARAKHAND,2009,Car (Private),40,8,48
UTTARAKHAND,2009,Three Wheeler,15,3,18
UTTARAKHAND,2009,Two Wheeler,87,9,96
UTTARAKHAND,2009,Bicycle,17,0,17
UTTARAKHAND,2009,Pedestrian,43,2,45
UTTARAKHAND,2009,Others (Please Specify),139,9,148
UTTARAKHAND,2009,Total Deaths (Persons),757,95,852
UTTARAKHAND,2009,Total Truck/Lorry,168,13,181
UTTARAKHAND,2009,Total Bus,109,26,135
UTTARAKHAND,2009,Total Tempo/Vans,40,5,45
UTTARAKHAND,2009,Total Jeep,93,16,109
UTTARAKHAND,2009,Total Car,46,12,58
UTTARAKHAND,2010,Truck/Lorry (Government),11,0,11
UTTARAKHAND,2010,Truck/Lorry (Private),94,12,106
UTTARAKHAND,2010,Bus (Government),10,2,12
UTTARAKHAND,2010,Bus (Private),77,14,91
UTTARAKHAND,2010,Tempo/Vans (Government),0,0,0
UTTARAKHAND,2010,Tempo/Vans (Private),43,8,51
UTTARAKHAND,2010,Jeep (Government),8,0,8
UTTARAKHAND,2010,Jeep (Private),53,18,71
UTTARAKHAND,2010,Car (Government),41,3,44
UTTARAKHAND,2010,Car (Private),86,35,121
UTTARAKHAND,2010,Three Wheeler,25,9,34
UTTARAKHAND,2010,Two Wheeler,175,21,196
UTTARAKHAND,2010,Bicycle,21,3,24
UTTARAKHAND,2010,Pedestrian,55,8,63
UTTARAKHAND,2010,Others (Please Specify),80,5,85
UTTARAKHAND,2010,Total Deaths (Persons),779,138,917
UTTARAKHAND,2010,Total Truck/Lorry,105,12,117
UTTARAKHAND,2010,Total Bus,87,16,103
UTTARAKHAND,2010,Total Tempo/Vans,43,8,51
UTTARAKHAND,2010,Total Jeep,61,18,79
UTTARAKHAND,2010,Total Car,127,38,165
UTTARAKHAND,2011,Truck/Lorry (Government),12,0,12
UTTARAKHAND,2011,Truck/Lorry (Private),158,13,171
UTTARAKHAND,2011,Bus (Government),0,0,0
UTTARAKHAND,2011,Bus (Private),20,33,53
UTTARAKHAND,2011,Tempo/Vans (Government),0,0,0
UTTARAKHAND,2011,Tempo/Vans (Private),138,22,160
UTTARAKHAND,2011,Jeep (Government),8,0,8
UTTARAKHAND,2011,Jeep (Private),23,5,28
UTTARAKHAND,2011,Car (Government),17,3,20
UTTARAKHAND,2011,Car (Private),65,14,79
UTTARAKHAND,2011,Three Wheeler,3,16,19
UTTARAKHAND,2011,Two Wheeler,161,14,175
UTTARAKHAND,2011,Bicycle,12,1,13
UTTARAKHAND,2011,Pedestrian,21,2,23
UTTARAKHAND,2011,Others (Please Specify),137,24,161
UTTARAKHAND,2011,Total Deaths (Persons),775,147,922
UTTARAKHAND,2011,Total Truck/Lorry,170,13,183
UTTARAKHAND,2011,Total Bus,20,33,53
UTTARAKHAND,2011,Total Tempo/Vans,138,22,160
UTTARAKHAND,2011,Total Jeep,31,5,36
UTTARAKHAND,2011,Total Car,82,17,99
UTTARAKHAND,2012,Truck/Lorry (Government),2,0,2
UTTARAKHAND,2012,Truck/Lorry (Private),100,25,125
UTTARAKHAND,2012,Bus (Government),21,5,26
UTTARAKHAND,2012,Bus (Private),66,29,95
UTTARAKHAND,2012,Tempo/Vans (Government),2,0,2
UTTARAKHAND,2012,Tempo/Vans (Private),11,1,12
UTTARAKHAND,2012,Jeep (Government),1,0,1
UTTARAKHAND,2012,Jeep (Private),49,13,62
UTTARAKHAND,2012,Car (Government),3,1,4
UTTARAKHAND,2012,Car (Private),107,20,127
UTTARAKHAND,2012,Three Wheeler,10,7,17
UTTARAKHAND,2012,Two Wheeler,168,10,178
UTTARAKHAND,2012,Bicycle,19,2,21
UTTARAKHAND,2012,Pedestrian,66,9,75
UTTARAKHAND,2012,Others (Please Specify),65,15,80
UTTARAKHAND,2012,Total Deaths (Persons),690,137,827
UTTARAKHAND,2012,Total Truck/Lorry,102,25,127
UTTARAKHAND,2012,Total Bus,87,34,121
UTTARAKHAND,2012,Total Tempo/Vans,13,1,14
UTTARAKHAND,2012,Total Jeep,50,13,63
UTTARAKHAND,2012,Total Car,110,21,131
WEST BENGAL,2001,Truck/Lorry (Government),37,6,43
WEST BENGAL,2001,Truck/Lorry (Private),747,214,961
WEST BENGAL,2001,Bus (Government),106,58,164
WEST BENGAL,2001,Bus (Private),701,327,1028
WEST BENGAL,2001,Tempo/Vans (Government),7,0,7
WEST BENGAL,2001,Tempo/Vans (Private),151,79,230
WEST BENGAL,2001,Jeep (Government),17,1,18
WEST BENGAL,2001,Jeep (Private),118,52,170
WEST BENGAL,2001,Car (Government),17,3,20
WEST BENGAL,2001,Car (Private),253,100,353
WEST BENGAL,2001,Three Wheeler,32,26,58
WEST BENGAL,2001,Two Wheeler,155,35,190
WEST BENGAL,2001,Bicycle,66,7,73
WEST BENGAL,2001,Pedestrian,94,52,146
WEST BENGAL,2001,Others (Please Specify),326,172,498
WEST BENGAL,2001,Total Deaths (Persons),2827,1132,3959
WEST BENGAL,2001,Total Truck/Lorry,784,220,1004
WEST BENGAL,2001,Total Bus,807,385,1192
WEST BENGAL,2001,Total Tempo/Vans,158,79,237
WEST BENGAL,2001,Total Jeep,135,53,188
WEST BENGAL,2001,Total Car,270,103,373
WEST BENGAL,2002,Truck/Lorry (Government),155,56,211
WEST BENGAL,2002,Truck/Lorry (Private),715,256,971
WEST BENGAL,2002,Bus (Government),100,35,135
WEST BENGAL,2002,Bus (Private),698,265,963
WEST BENGAL,2002,Tempo/Vans (Government),5,3,8
WEST BENGAL,2002,Tempo/Vans (Private),120,87,207
WEST BENGAL,2002,Jeep (Government),19,6,25
WEST BENGAL,2002,Jeep (Private),161,46,207
WEST BENGAL,2002,Car (Government),4,3,7
WEST BENGAL,2002,Car (Private),222,92,314
WEST BENGAL,2002,Three Wheeler,44,25,69
WEST BENGAL,2002,Two Wheeler,178,69,247
WEST BENGAL,2002,Bicycle,84,12,96
WEST BENGAL,2002,Pedestrian,179,64,243
WEST BENGAL,2002,Others (Please Specify),305,131,436
WEST BENGAL,2002,Total Deaths (Persons),2989,1150,4139
WEST BENGAL,2002,Total Truck/Lorry,870,312,1182
WEST BENGAL,2002,Total Bus,798,300,1098
WEST BENGAL,2002,Total Tempo/Vans,125,90,215
WEST BENGAL,2002,Total Jeep,180,52,232
WEST BENGAL,2002,Total Car,226,95,321
WEST BENGAL,2003,Truck/Lorry (Government),19,4,23
WEST BENGAL,2003,Truck/Lorry (Private),1122,271,1393
WEST BENGAL,2003,Bus (Government),91,34,125
WEST BENGAL,2003,Bus (Private),702,225,927
WEST BENGAL,2003,Tempo/Vans (Government),0,0,0
WEST BENGAL,2003,Tempo/Vans (Private),301,75,376
WEST BENGAL,2003,Jeep (Government),19,4,23
WEST BENGAL,2003,Jeep (Private),185,41,226
WEST BENGAL,2003,Car (Government),3,1,4
WEST BENGAL,2003,Car (Private),222,75,297
WEST BENGAL,2003,Three Wheeler,64,12,76
WEST BENGAL,2003,Two Wheeler,299,59,358
WEST BENGAL,2003,Bicycle,45,2,47
WEST BENGAL,2003,Pedestrian,52,23,75
WEST BENGAL,2003,Others (Please Specify),128,49,177
WEST BENGAL,2003,Total Deaths (Persons),3252,875,4127
WEST BENGAL,2003,Total Truck/Lorry,1141,275,1416
WEST BENGAL,2003,Total Bus,793,259,1052
WEST BENGAL,2003,Total Tempo/Vans,301,75,376
WEST BENGAL,2003,Total Jeep,204,45,249
WEST BENGAL,2003,Total Car,225,76,301
WEST BENGAL,2004,Truck/Lorry (Government),13,4,17
WEST BENGAL,2004,Truck/Lorry (Private),920,274,1194
WEST BENGAL,2004,Bus (Government),80,30,110
WEST BENGAL,2004,Bus (Private),646,248,894
WEST BENGAL,2004,Tempo/Vans (Government),7,1,8
WEST BENGAL,2004,Tempo/Vans (Private),194,86,280
WEST BENGAL,2004,Jeep (Government),7,0,7
WEST BENGAL,2004,Jeep (Private),174,68,242
WEST BENGAL,2004,Car (Government),15,3,18
WEST BENGAL,2004,Car (Private),342,128,470
WEST BENGAL,2004,Three Wheeler,60,17,77
WEST BENGAL,2004,Two Wheeler,252,65,317
WEST BENGAL,2004,Bicycle,45,1,46
WEST BENGAL,2004,Pedestrian,155,54,209
WEST BENGAL,2004,Others (Please Specify),235,145,380
WEST BENGAL,2004,Total Deaths (Persons),3145,1124,4269
WEST BENGAL,2004,Total Truck/Lorry,933,278,1211
WEST BENGAL,2004,Total Bus,726,278,1004
WEST BENGAL,2004,Total Tempo/Vans,201,87,288
WEST BENGAL,2004,Total Jeep,181,68,249
WEST BENGAL,2004,Total Car,357,131,488
WEST BENGAL,2005,Truck/Lorry (Government),12,2,14
WEST BENGAL,2005,Truck/Lorry (Private),1024,248,1272
WEST BENGAL,2005,Bus (Government),54,14,68
WEST BENGAL,2005,Bus (Private),802,243,1045
WEST BENGAL,2005,Tempo/Vans (Government),2,0,2
WEST BENGAL,2005,Tempo/Vans (Private),170,52,222
WEST BENGAL,2005,Jeep (Government),12,1,13
WEST BENGAL,2005,Jeep (Private),177,55,232
WEST BENGAL,2005,Car (Government),4,1,5
WEST BENGAL,2005,Car (Private),275,84,359
WEST BENGAL,2005,Three Wheeler,40,10,50
WEST BENGAL,2005,Two Wheeler,269,64,333
WEST BENGAL,2005,Bicycle,32,4,36
WEST BENGAL,2005,Pedestrian,292,78,370
WEST BENGAL,2005,Others (Please Specify),242,101,343
WEST BENGAL,2005,Total Deaths (Persons),3407,957,4364
WEST BENGAL,2005,Total Truck/Lorry,1036,250,1286
WEST BENGAL,2005,Total Bus,856,257,1113
WEST BENGAL,2005,Total Tempo/Vans,172,52,224
WEST BENGAL,2005,Total Jeep,189,56,245
WEST BENGAL,2005,Total Car,279,85,364
WEST BENGAL,2006,Truck/Lorry (Government),24,8,32
WEST BENGAL,2006,Truck/Lorry (Private),1301,295,1596
WEST BENGAL,2006,Bus (Government),45,14,59
WEST BENGAL,2006,Bus (Private),697,201,898
WEST BENGAL,2006,Tempo/Vans (Government),1,0,1
WEST BENGAL,2006,Tempo/Vans (Private),320,93,413
WEST BENGAL,2006,Jeep (Government),23,7,30
WEST BENGAL,2006,Jeep (Private),202,98,300
WEST BENGAL,2006,Car (Government),1,0,1
WEST BENGAL,2006,Car (Private),310,99,409
WEST BENGAL,2006,Three Wheeler,47,6,53
WEST BENGAL,2006,Two Wheeler,274,71,345
WEST BENGAL,2006,Bicycle,46,2,48
WEST BENGAL,2006,Pedestrian,285,79,364
WEST BENGAL,2006,Others (Please Specify),7,1,8
WEST BENGAL,2006,Total Deaths (Persons),3583,974,4557
WEST BENGAL,2006,Total Truck/Lorry,1325,303,1628
WEST BENGAL,2006,Total Bus,742,215,957
WEST BENGAL,2006,Total Tempo/Vans,321,93,414
WEST BENGAL,2006,Total Jeep,225,105,330
WEST BENGAL,2006,Total Car,311,99,410
WEST BENGAL,2007,Truck/Lorry (Government),19,4,23
WEST BENGAL,2007,Truck/Lorry (Private),1253,267,1520
WEST BENGAL,2007,Bus (Government),51,8,59
WEST BENGAL,2007,Bus (Private),695,229,924
WEST BENGAL,2007,Tempo/Vans (Government),4,1,5
WEST BENGAL,2007,Tempo/Vans (Private),95,16,111
WEST BENGAL,2007,Jeep (Government),9,0,9
WEST BENGAL,2007,Jeep (Private),197,51,248
WEST BENGAL,2007,Car (Government),12,1,13
WEST BENGAL,2007,Car (Private),331,93,424
WEST BENGAL,2007,Three Wheeler,60,4,64
WEST BENGAL,2007,Two Wheeler,411,92,503
WEST BENGAL,2007,Bicycle,94,8,102
WEST BENGAL,2007,Pedestrian,370,112,482
WEST BENGAL,2007,Others (Please Specify),371,61,432
WEST BENGAL,2007,Total Deaths (Persons),3972,947,4919
WEST BENGAL,2007,Total Truck/Lorry,1272,271,1543
WEST BENGAL,2007,Total Bus,746,237,983
WEST BENGAL,2007,Total Tempo/Vans,99,17,116
WEST BENGAL,2007,Total Jeep,206,51,257
WEST BENGAL,2007,Total Car,343,94,437
WEST BENGAL,2008,Truck/Lorry (Government),14,1,15
WEST BENGAL,2008,Truck/Lorry (Private),1321,218,1539
WEST BENGAL,2008,Bus (Government),51,16,67
WEST BENGAL,2008,Bus (Private),657,228,885
WEST BENGAL,2008,Tempo/Vans (Government),2,0,2
WEST BENGAL,2008,Tempo/Vans (Private),99,23,122
WEST BENGAL,2008,Jeep (Government),18,6,24
WEST BENGAL,2008,Jeep (Private),152,29,181
WEST BENGAL,2008,Car (Government),37,17,54
WEST BENGAL,2008,Car (Private),357,67,424
WEST BENGAL,2008,Three Wheeler,74,18,92
WEST BENGAL,2008,Two Wheeler,430,92,522
WEST BENGAL,2008,Bicycle,0,0,0
WEST BENGAL,2008,Pedestrian,0,0,0
WEST BENGAL,2008,Others (Please Specify),630,182,812
WEST BENGAL,2008,Total Deaths (Persons),3842,897,4739
WEST BENGAL,2008,Total Truck/Lorry,1335,219,1554
WEST BENGAL,2008,Total Bus,708,244,952
WEST BENGAL,2008,Total Tempo/Vans,101,23,124
WEST BENGAL,2008,Total Jeep,170,35,205
WEST BENGAL,2008,Total Car,394,84,478
WEST BENGAL,2009,Truck/Lorry (Government),2,3,5
WEST BENGAL,2009,Truck/Lorry (Private),1147,183,1330
WEST BENGAL,2009,Bus (Government),55,11,66
WEST BENGAL,2009,Bus (Private),558,185,743
WEST BENGAL,2009,Tempo/Vans (Government),1,0,1
WEST BENGAL,2009,Tempo/Vans (Private),193,36,229
WEST BENGAL,2009,Jeep (Government),4,1,5
WEST BENGAL,2009,Jeep (Private),126,21,147
WEST BENGAL,2009,Car (Government),5,0,5
WEST BENGAL,2009,Car (Private),336,88,424
WEST BENGAL,2009,Three Wheeler,77,14,91
WEST BENGAL,2009,Two Wheeler,457,101,558
WEST BENGAL,2009,Bicycle,127,13,140
WEST BENGAL,2009,Pedestrian,567,132,699
WEST BENGAL,2009,Others (Please Specify),476,95,571
WEST BENGAL,2009,Total Deaths (Persons),4131,883,5014
WEST BENGAL,2009,Total Truck/Lorry,1149,186,1335
WEST BENGAL,2009,Total Bus,613,196,809
WEST BENGAL,2009,Total Tempo/Vans,194,36,230
WEST BENGAL,2009,Total Jeep,130,22,152
WEST BENGAL,2009,Total Car,341,88,429
WEST BENGAL,2010,Truck/Lorry (Government),7,9,16
WEST BENGAL,2010,Truck/Lorry (Private),1294,308,1602
WEST BENGAL,2010,Bus (Government),59,23,82
WEST BENGAL,2010,Bus (Private),546,202,748
WEST BENGAL,2010,Tempo/Vans (Government),8,2,10
WEST BENGAL,2010,Tempo/Vans (Private),168,28,196
WEST BENGAL,2010,Jeep (Government),14,5,19
WEST BENGAL,2010,Jeep (Private),127,53,180
WEST BENGAL,2010,Car (Government),4,0,4
WEST BENGAL,2010,Car (Private),323,113,436
WEST BENGAL,2010,Three Wheeler,93,15,108
WEST BENGAL,2010,Two Wheeler,562,117,679
WEST BENGAL,2010,Bicycle,142,19,161
WEST BENGAL,2010,Pedestrian,495,131,626
WEST BENGAL,2010,Others (Please Specify),467,136,603
WEST BENGAL,2010,Total Deaths (Persons),4309,1161,5470
WEST BENGAL,2010,Total Truck/Lorry,1301,317,1618
WEST BENGAL,2010,Total Bus,605,225,830
WEST BENGAL,2010,Total Tempo/Vans,176,30,206
WEST BENGAL,2010,Total Jeep,141,58,199
WEST BENGAL,2010,Total Car,327,113,440
WEST BENGAL,2011,Truck/Lorry (Government),3,2,5
WEST BENGAL,2011,Truck/Lorry (Private),1262,267,1529
WEST BENGAL,2011,Bus (Government),73,16,89
WEST BENGAL,2011,Bus (Private),585,182,767
WEST BENGAL,2011,Tempo/Vans (Government),9,2,11
WEST BENGAL,2011,Tempo/Vans (Private),236,42,278
WEST BENGAL,2011,Jeep (Government),8,3,11
WEST BENGAL,2011,Jeep (Private),112,35,147
WEST BENGAL,2011,Car (Government),11,1,12
WEST BENGAL,2011,Car (Private),400,91,491
WEST BENGAL,2011,Three Wheeler,91,23,114
WEST BENGAL,2011,Two Wheeler,708,136,844
WEST BENGAL,2011,Bicycle,97,15,112
WEST BENGAL,2011,Pedestrian,422,89,511
WEST BENGAL,2011,Others (Please Specify),591,134,725
WEST BENGAL,2011,Total Deaths (Persons),4608,1038,5646
WEST BENGAL,2011,Total Truck/Lorry,1265,269,1534
WEST BENGAL,2011,Total Bus,658,198,856
WEST BENGAL,2011,Total Tempo/Vans,245,44,289
WEST BENGAL,2011,Total Jeep,120,38,158
WEST BENGAL,2011,Total Car,411,92,503
WEST BENGAL,2012,Truck/Lorry (Government),14,6,20
WEST BENGAL,2012,Truck/Lorry (Private),1431,330,1761
WEST BENGAL,2012,Bus (Government),72,27,99
WEST BENGAL,2012,Bus (Private),464,177,641
WEST BENGAL,2012,Tempo/Vans (Government),5,1,6
WEST BENGAL,2012,Tempo/Vans (Private),191,39,230
WEST BENGAL,2012,Jeep (Government),9,3,12
WEST BENGAL,2012,Jeep (Private),147,42,189
WEST BENGAL,2012,Car (Government),12,1,13
WEST BENGAL,2012,Car (Private),437,103,540
WEST BENGAL,2012,Three Wheeler,77,27,104
WEST BENGAL,2012,Two Wheeler,852,143,995
WEST BENGAL,2012,Bicycle,184,16,200
WEST BENGAL,2012,Pedestrian,521,145,666
WEST BENGAL,2012,Others (Please Specify),543,203,746
WEST BENGAL,2012,Total Deaths (Persons),4959,1263,6222
WEST BENGAL,2012,Total Truck/Lorry,1445,336,1781
WEST BENGAL,2012,Total Bus,536,204,740
WEST BENGAL,2012,Total Tempo/Vans,196,40,236
WEST BENGAL,2012,Total Jeep,156,45,201
WEST BENGAL,2012,Total Car,449,104,553
TOTAL (STATES),2001,Truck/Lorry (Government),501,114,615
TOTAL (STATES),2001,Truck/Lorry (Private),17482,2700,20182
TOTAL (STATES),2001,Bus (Government),3820,853,4673
TOTAL (STATES),2001,Bus (Private),5487,1516,7003
TOTAL (STATES),2001,Tempo/Vans (Government),157,36,193
TOTAL (STATES),2001,Tempo/Vans (Private),4256,988,5244
TOTAL (STATES),2001,Jeep (Government),290,45,335
TOTAL (STATES),2001,Jeep (Private),6620,1445,8065
TOTAL (STATES),2001,Car (Government),180,37,217
TOTAL (STATES),2001,Car (Private),3955,1023,4978
TOTAL (STATES),2001,Three Wheeler,2369,589,2958
TOTAL (STATES),2001,Two Wheeler,8102,1074,9176
TOTAL (STATES),2001,Bicycle,1846,206,2052
TOTAL (STATES),2001,Pedestrian,4811,1343,6154
TOTAL (STATES),2001,Others (Please Specify),5049,1117,6166
TOTAL (STATES),2001,Total Deaths (Persons),64925,13086,78011
TOTAL (STATES),2001,Total Truck/Lorry,17983,2814,20797
TOTAL (STATES),2001,Total Bus,9307,2369,11676
TOTAL (STATES),2001,Total Tempo/Vans,4413,1024,5437
TOTAL (STATES),2001,Total Jeep,6910,1490,8400
TOTAL (STATES),2001,Total Car,4135,1060,5195
TOTAL (STATES),2002,Truck/Lorry (Government),601,166,767
TOTAL (STATES),2002,Truck/Lorry (Private),18037,2484,20521
TOTAL (STATES),2002,Bus (Government),3517,686,4203
TOTAL (STATES),2002,Bus (Private),5578,1458,7036
TOTAL (STATES),2002,Tempo/Vans (Government),186,32,218
TOTAL (STATES),2002,Tempo/Vans (Private),4510,934,5444
TOTAL (STATES),2002,Jeep (Government),246,39,285
TOTAL (STATES),2002,Jeep (Private),6325,1365,7690
TOTAL (STATES),2002,Car (Government),313,72,385
TOTAL (STATES),2002,Car (Private),4062,962,5024
TOTAL (STATES),2002,Three Wheeler,3041,627,3668
TOTAL (STATES),2002,Two Wheeler,9413,1300,10713
TOTAL (STATES),2002,Bicycle,2208,214,2422
TOTAL (STATES),2002,Pedestrian,5515,1273,6788
TOTAL (STATES),2002,Others (Please Specify),5504,1252,6756
TOTAL (STATES),2002,Total Deaths (Persons),69056,12864,81920
TOTAL (STATES),2002,Total Truck/Lorry,18638,2650,21288
TOTAL (STATES),2002,Total Bus,9095,2144,11239
TOTAL (STATES),2002,Total Tempo/Vans,4696,966,5662
TOTAL (STATES),2002,Total Jeep,6571,1404,7975
TOTAL (STATES),2002,Total Car,4375,1034,5409
TOTAL (STATES),2003,Truck/Lorry (Government),812,63,875
TOTAL (STATES),2003,Truck/Lorry (Private),17590,2582,20172
TOTAL (STATES),2003,Bus (Government),2749,710,3459
TOTAL (STATES),2003,Bus (Private),5783,1434,7217
TOTAL (STATES),2003,Tempo/Vans (Government),84,13,97
TOTAL (STATES),2003,Tempo/Vans (Private),4257,915,5172
TOTAL (STATES),2003,Jeep (Government),182,54,236
TOTAL (STATES),2003,Jeep (Private),6624,1472,8096
TOTAL (STATES),2003,Car (Government),80,12,92
TOTAL (STATES),2003,Car (Private),4491,1077,5568
TOTAL (STATES),2003,Three Wheeler,2959,694,3653
TOTAL (STATES),2003,Two Wheeler,10721,1541,12262
TOTAL (STATES),2003,Bicycle,1883,129,2012
TOTAL (STATES),2003,Pedestrian,5557,1248,6805
TOTAL (STATES),2003,Others (Please Specify),5317,1093,6410
TOTAL (STATES),2003,Total Deaths (Persons),69089,13037,82126
TOTAL (STATES),2003,Total Truck/Lorry,18402,2645,21047
TOTAL (STATES),2003,Total Bus,8532,2144,10676
TOTAL (STATES),2003,Total Tempo/Vans,4341,928,5269
TOTAL (STATES),2003,Total Jeep,6806,1526,8332
TOTAL (STATES),2003,Total Car,4571,1089,5660
TOTAL (STATES),2004,Truck/Lorry (Government),404,61,465
TOTAL (STATES),2004,Truck/Lorry (Private),18456,2633,21089
TOTAL (STATES),2004,Bus (Government),3340,748,4088
TOTAL (STATES),2004,Bus (Private),5154,1303,6457
TOTAL (STATES),2004,Tempo/Vans (Government),131,21,152
TOTAL (STATES),2004,Tempo/Vans (Private),4736,1030,5766
TOTAL (STATES),2004,Jeep (Government),167,29,196
TOTAL (STATES),2004,Jeep (Private),6841,1459,8300
TOTAL (STATES),2004,Car (Government),152,33,185
TOTAL (STATES),2004,Car (Private),5076,1117,6193
TOTAL (STATES),2004,Three Wheeler,3650,822,4472
TOTAL (STATES),2004,Two Wheeler,12351,1737,14088
TOTAL (STATES),2004,Bicycle,2213,199,2412
TOTAL (STATES),2004,Pedestrian,6009,1516,7525
TOTAL (STATES),2004,Others (Please Specify),6385,1222,7607
TOTAL (STATES),2004,Total Deaths (Persons),75065,13930,88995
TOTAL (STATES),2004,Total Truck/Lorry,18860,2694,21554
TOTAL (STATES),2004,Total Bus,8494,2051,10545
TOTAL (STATES),2004,Total Tempo/Vans,4867,1051,5918
TOTAL (STATES),2004,Total Jeep,7008,1488,8496
TOTAL (STATES),2004,Total Car,5228,1150,6378
TOTAL (STATES),2005,Truck/Lorry (Government),628,87,715
TOTAL (STATES),2005,Truck/Lorry (Private),18768,2870,21638
TOTAL (STATES),2005,Bus (Government),3328,698,4026
TOTAL (STATES),2005,Bus (Private),6440,1540,7980
TOTAL (STATES),2005,Tempo/Vans (Government),152,77,229
TOTAL (STATES),2005,Tempo/Vans (Private),5124,1001,6125
TOTAL (STATES),2005,Jeep (Government),290,43,333
TOTAL (STATES),2005,Jeep (Private),6857,1340,8197
TOTAL (STATES),2005,Car (Government),133,25,158
TOTAL (STATES),2005,Car (Private),5978,1248,7226
TOTAL (STATES),2005,Three Wheeler,3845,850,4695
TOTAL (STATES),2005,Two Wheeler,13458,2032,15490
TOTAL (STATES),2005,Bicycle,2599,181,2780
TOTAL (STATES),2005,Pedestrian,6684,1551,8235
TOTAL (STATES),2005,Others (Please Specify),6736,1206,7942
TOTAL (STATES),2005,Total Deaths (Persons),81020,14749,95769
TOTAL (STATES),2005,Total Truck/Lorry,19396,2957,22353
TOTAL (STATES),2005,Total Bus,9768,2238,12006
TOTAL (STATES),2005,Total Tempo/Vans,5276,1078,6354
TOTAL (STATES),2005,Total Jeep,7147,1383,8530
TOTAL (STATES),2005,Total Car,6111,1273,7384
TOTAL (STATES),2006,Truck/Lorry (Government),433,77,510
TOTAL (STATES),2006,Truck/Lorry (Private),20324,2812,23136
TOTAL (STATES),2006,Bus (Government),3504,798,4302
TOTAL (STATES),2006,Bus (Private),6464,1635,8099
TOTAL (STATES),2006,Tempo/Vans (Government),124,27,151
TOTAL (STATES),2006,Tempo/Vans (Private),4362,1007,5369
TOTAL (STATES),2006,Jeep (Government),207,56,263
TOTAL (STATES),2006,Jeep (Private),7250,1577,8827
TOTAL (STATES),2006,Car (Government),144,36,180
TOTAL (STATES),2006,Car (Private),7214,1965,9179
TOTAL (STATES),2006,Three Wheeler,4660,1116,5776
TOTAL (STATES),2006,Two Wheeler,15881,2288,18169
TOTAL (STATES),2006,Bicycle,2549,233,2782
TOTAL (STATES),2006,Pedestrian,6749,1420,8169
TOTAL (STATES),2006,Others (Please Specify),6945,1248,8193
TOTAL (STATES),2006,Total Deaths (Persons),86810,16295,103105
TOTAL (STATES),2006,Total Truck/Lorry,20757,2889,23646
TOTAL (STATES),2006,Total Bus,9968,2433,12401
TOTAL (STATES),2006,Total Tempo/Vans,4486,1034,5520
TOTAL (STATES),2006,Total Jeep,7457,1633,9090
TOTAL (STATES),2006,Total Car,7358,2001,9359
TOTAL (STATES),2007,Truck/Lorry (Government),550,105,655
TOTAL (STATES),2007,Truck/Lorry (Private),20892,2945,23837
TOTAL (STATES),2007,Bus (Government),2967,708,3675
TOTAL (STATES),2007,Bus (Private),7411,1588,8999
TOTAL (STATES),2007,Tempo/Vans (Government),187,44,231
TOTAL (STATES),2007,Tempo/Vans (Private),4639,1044,5683
TOTAL (STATES),2007,Jeep (Government),291,58,349
TOTAL (STATES),2007,Jeep (Private),7719,1582,9301
TOTAL (STATES),2007,Car (Government),136,28,164
TOTAL (STATES),2007,Car (Private),8008,1564,9572
TOTAL (STATES),2007,Three Wheeler,5250,1143,6393
TOTAL (STATES),2007,Two Wheeler,18418,2732,21150
TOTAL (STATES),2007,Bicycle,2714,226,2940
TOTAL (STATES),2007,Pedestrian,7715,1681,9396
TOTAL (STATES),2007,Others (Please Specify),8123,1476,9599
TOTAL (STATES),2007,Total Deaths (Persons),95020,16924,111944
TOTAL (STATES),2007,Total Truck/Lorry,21442,3050,24492
TOTAL (STATES),2007,Total Bus,10378,2296,12674
TOTAL (STATES),2007,Total Tempo/Vans,4826,1088,5914
TOTAL (STATES),2007,Total Jeep,8010,1640,9650
TOTAL (STATES),2007,Total Car,8144,1592,9736
TOTAL (STATES),2008,Truck/Lorry (Government),425,57,482
TOTAL (STATES),2008,Truck/Lorry (Private),21603,2814,24417
TOTAL (STATES),2008,Bus (Government),3315,1030,4345
TOTAL (STATES),2008,Bus (Private),6456,1571,8027
TOTAL (STATES),2008,Tempo/Vans (Government),109,12,121
TOTAL (STATES),2008,Tempo/Vans (Private),4950,1063,6013
TOTAL (STATES),2008,Jeep (Government),250,49,299
TOTAL (STATES),2008,Jeep (Private),7764,1523,9287
TOTAL (STATES),2008,Car (Government),184,57,241
TOTAL (STATES),2008,Car (Private),8234,1566,9800
TOTAL (STATES),2008,Three Wheeler,5244,1210,6454
TOTAL (STATES),2008,Two Wheeler,19761,3065,22826
TOTAL (STATES),2008,Bicycle,2861,537,3398
TOTAL (STATES),2008,Pedestrian,7933,1752,9685
TOTAL (STATES),2008,Others (Please Specify),8921,1359,10280
TOTAL (STATES),2008,Total Deaths (Persons),98010,17665,115675
TOTAL (STATES),2008,Total Truck/Lorry,22028,2871,24899
TOTAL (STATES),2008,Total Bus,9771,2601,12372
TOTAL (STATES),2008,Total Tempo/Vans,5059,1075,6134
TOTAL (STATES),2008,Total Jeep,8014,1572,9586
TOTAL (STATES),2008,Total Car,8418,1623,10041
TOTAL (STATES),2009,Truck/Lorry (Government),532,68,600
TOTAL (STATES),2009,Truck/Lorry (Private),21608,2760,24368
TOTAL (STATES),2009,Bus (Government),3017,776,3793
TOTAL (STATES),2009,Bus (Private),7202,1688,8890
TOTAL (STATES),2009,Tempo/Vans (Government),362,75,437
TOTAL (STATES),2009,Tempo/Vans (Private),5811,1080,6891
TOTAL (STATES),2009,Jeep (Government),195,31,226
TOTAL (STATES),2009,Jeep (Private),7890,1687,9577
TOTAL (STATES),2009,Car (Government),265,33,298
TOTAL (STATES),2009,Car (Private),9469,1739,11208
TOTAL (STATES),2009,Three Wheeler,5299,1245,6544
TOTAL (STATES),2009,Two Wheeler,22358,2963,25321
TOTAL (STATES),2009,Bicycle,2853,237,3090
TOTAL (STATES),2009,Pedestrian,8579,1961,10540
TOTAL (STATES),2009,Others (Please Specify),10703,1901,12604
TOTAL (STATES),2009,Total Deaths (Persons),106143,18244,124387
TOTAL (STATES),2009,Total Truck/Lorry,22140,2828,24968
TOTAL (STATES),2009,Total Bus,10219,2464,12683
TOTAL (STATES),2009,Total Tempo/Vans,6173,1155,7328
TOTAL (STATES),2009,Total Jeep,8085,1718,9803
TOTAL (STATES),2009,Total Car,9734,1772,11506
TOTAL (STATES),2010,Truck/Lorry (Government),714,127,841
TOTAL (STATES),2010,Truck/Lorry (Private),22555,3209,25764
TOTAL (STATES),2010,Bus (Government),3334,838,4172
TOTAL (STATES),2010,Bus (Private),6991,1696,8687
TOTAL (STATES),2010,Tempo/Vans (Government),166,24,190
TOTAL (STATES),2010,Tempo/Vans (Private),6747,1365,8112
TOTAL (STATES),2010,Jeep (Government),227,43,270
TOTAL (STATES),2010,Jeep (Private),7978,1753,9731
TOTAL (STATES),2010,Car (Government),257,34,291
TOTAL (STATES),2010,Car (Private),9669,1980,11649
TOTAL (STATES),2010,Three Wheeler,5863,1282,7145
TOTAL (STATES),2010,Two Wheeler,24111,3292,27403
TOTAL (STATES),2010,Bicycle,2831,257,3088
TOTAL (STATES),2010,Pedestrian,9448,2091,11539
TOTAL (STATES),2010,Others (Please Specify),10664,1733,12397
TOTAL (STATES),2010,Total Deaths (Persons),111555,19724,131279
TOTAL (STATES),2010,Total Truck/Lorry,23269,3336,26605
TOTAL (STATES),2010,Total Bus,10325,2534,12859
TOTAL (STATES),2010,Total Tempo/Vans,6913,1389,8302
TOTAL (STATES),2010,Total Jeep,8205,1796,10001
TOTAL (STATES),2010,Total Car,9926,2014,11940
TOTAL (STATES),2011,Truck/Lorry (Government),334,63,397
TOTAL (STATES),2011,Truck/Lorry (Private),23074,2934,26008
TOTAL (STATES),2011,Bus (Government),3212,624,3836
TOTAL (STATES),2011,Bus (Private),6887,1645,8532
TOTAL (STATES),2011,Tempo/Vans (Government),226,40,266
TOTAL (STATES),2011,Tempo/Vans (Private),6777,1386,8163
TOTAL (STATES),2011,Jeep (Government),185,26,211
TOTAL (STATES),2011,Jeep (Private),7654,1577,9231
TOTAL (STATES),2011,Car (Government),292,55,347
TOTAL (STATES),2011,Car (Private),10691,2118,12809
TOTAL (STATES),2011,Three Wheeler,5410,1309,6719
TOTAL (STATES),2011,Two Wheeler,26217,3605,29822
TOTAL (STATES),2011,Bicycle,2767,266,3033
TOTAL (STATES),2011,Pedestrian,9539,2184,11723
TOTAL (STATES),2011,Others (Please Specify),11089,2071,13160
TOTAL (STATES),2011,Total Deaths (Persons),114354,19903,134257
TOTAL (STATES),2011,Total Truck/Lorry,23408,2997,26405
TOTAL (STATES),2011,Total Bus,10099,2269,12368
TOTAL (STATES),2011,Total Tempo/Vans,7003,1426,8429
TOTAL (STATES),2011,Total Jeep,7839,1603,9442
TOTAL (STATES),2011,Total Car,10983,2173,13156
TOTAL (STATES),2012,Truck/Lorry (Government),386,77,463
TOTAL (STATES),2012,Truck/Lorry (Private),22972,3056,26028
TOTAL (STATES),2012,Bus (Government),3672,708,4380
TOTAL (STATES),2012,Bus (Private),6889,1696,8585
TOTAL (STATES),2012,Tempo/Vans (Government),99,29,128
TOTAL (STATES),2012,Tempo/Vans (Private),6337,1284,7621
TOTAL (STATES),2012,Jeep (Government),206,41,247
TOTAL (STATES),2012,Jeep (Private),7448,1564,9012
TOTAL (STATES),2012,Car (Government),350,62,412
TOTAL (STATES),2012,Car (Private),11412,2043,13455
TOTAL (STATES),2012,Three Wheeler,5399,1264,6663
TOTAL (STATES),2012,Two Wheeler,27943,3735,31678
TOTAL (STATES),2012,Bicycle,2771,197,2968
TOTAL (STATES),2012,Pedestrian,8580,2442,11022
TOTAL (STATES),2012,Others (Please Specify),11988,2121,14109
TOTAL (STATES),2012,Total Deaths (Persons),116452,20319,136771
TOTAL (STATES),2012,Total Truck/Lorry,23358,3133,26491
TOTAL (STATES),2012,Total Bus,10561,2404,12965
TOTAL (STATES),2012,Total Tempo/Vans,6436,1313,7749
TOTAL (STATES),2012,Total Jeep,7654,1605,9259
TOTAL (STATES),2012,Total Car,11762,2105,13867
A & N ISLANDS,2001,Truck/Lorry (Government),2,0,2
A & N ISLANDS,2001,Truck/Lorry (Private),3,0,3
A & N ISLANDS,2001,Bus (Government),1,0,1
A & N ISLANDS,2001,Bus (Private),1,0,1
A & N ISLANDS,2001,Tempo/Vans (Government),0,0,0
A & N ISLANDS,2001,Tempo/Vans (Private),2,0,2
A & N ISLANDS,2001,Jeep (Government),0,0,0
A & N ISLANDS,2001,Jeep (Private),0,0,0
A & N ISLANDS,2001,Car (Government),0,0,0
A & N ISLANDS,2001,Car (Private),1,0,1
A & N ISLANDS,2001,Three Wheeler,1,0,1
A & N ISLANDS,2001,Two Wheeler,3,1,4
A & N ISLANDS,2001,Bicycle,0,0,0
A & N ISLANDS,2001,Pedestrian,0,0,0
A & N ISLANDS,2001,Others (Please Specify),2,0,2
A & N ISLANDS,2001,Total Deaths (Persons),16,1,17
A & N ISLANDS,2001,Total Truck/Lorry,5,0,5
A & N ISLANDS,2001,Total Bus,2,0,2
A & N ISLANDS,2001,Total Tempo/Vans,2,0,2
A & N ISLANDS,2001,Total Jeep,0,0,0
A & N ISLANDS,2001,Total Car,1,0,1
A & N ISLANDS,2002,Truck/Lorry (Government),0,0,0
A & N ISLANDS,2002,Truck/Lorry (Private),4,0,4
A & N ISLANDS,2002,Bus (Government),0,0,0
A & N ISLANDS,2002,Bus (Private),4,2,6
A & N ISLANDS,2002,Tempo/Vans (Government),0,0,0
A & N ISLANDS,2002,Tempo/Vans (Private),1,0,1
A & N ISLANDS,2002,Jeep (Government),0,0,0
A & N ISLANDS,2002,Jeep (Private),3,0,3
A & N ISLANDS,2002,Car (Government),0,0,0
A & N ISLANDS,2002,Car (Private),2,0,2
A & N ISLANDS,2002,Three Wheeler,0,0,0
A & N ISLANDS,2002,Two Wheeler,4,0,4
A & N ISLANDS,2002,Bicycle,0,0,0
A & N ISLANDS,2002,Pedestrian,0,0,0
A & N ISLANDS,2002,Others (Please Specify),1,0,1
A & N ISLANDS,2002,Total Deaths (Persons),19,2,21
A & N ISLANDS,2002,Total Truck/Lorry,4,0,4
A & N ISLANDS,2002,Total Bus,4,2,6
A & N ISLANDS,2002,Total Tempo/Vans,1,0,1
A & N ISLANDS,2002,Total Jeep,3,0,3
A & N ISLANDS,2002,Total Car,2,0,2
A & N ISLANDS,2003,Truck/Lorry (Government),1,0,1
A & N ISLANDS,2003,Truck/Lorry (Private),1,0,1
A & N ISLANDS,2003,Bus (Government),0,0,0
A & N ISLANDS,2003,Bus (Private),3,0,3
A & N ISLANDS,2003,Tempo/Vans (Government),0,0,0
A & N ISLANDS,2003,Tempo/Vans (Private),0,0,0
A & N ISLANDS,2003,Jeep (Government),0,0,0
A & N ISLANDS,2003,Jeep (Private),1,0,1
A & N ISLANDS,2003,Car (Government),0,0,0
A & N ISLANDS,2003,Car (Private),0,0,0
A & N ISLANDS,2003,Three Wheeler,0,0,0
A & N ISLANDS,2003,Two Wheeler,5,1,6
A & N ISLANDS,2003,Bicycle,0,0,0
A & N ISLANDS,2003,Pedestrian,0,0,0
A & N ISLANDS,2003,Others (Please Specify),0,0,0
A & N ISLANDS,2003,Total Deaths (Persons),11,1,12
A & N ISLANDS,2003,Total Truck/Lorry,2,0,2
A & N ISLANDS,2003,Total Bus,3,0,3
A & N ISLANDS,2003,Total Tempo/Vans,0,0,0
A & N ISLANDS,2003,Total Jeep,1,0,1
A & N ISLANDS,2003,Total Car,0,0,0
A & N ISLANDS,2004,Truck/Lorry (Government),0,0,0
A & N ISLANDS,2004,Truck/Lorry (Private),1,0,1
A & N ISLANDS,2004,Bus (Government),0,0,0
A & N ISLANDS,2004,Bus (Private),0,1,1
A & N ISLANDS,2004,Tempo/Vans (Government),0,0,0
A & N ISLANDS,2004,Tempo/Vans (Private),0,0,0
A & N ISLANDS,2004,Jeep (Government),0,0,0
A & N ISLANDS,2004,Jeep (Private),1,0,1
A & N ISLANDS,2004,Car (Government),0,0,0
A & N ISLANDS,2004,Car (Private),0,0,0
A & N ISLANDS,2004,Three Wheeler,1,1,2
A & N ISLANDS,2004,Two Wheeler,3,1,4
A & N ISLANDS,2004,Bicycle,0,0,0
A & N ISLANDS,2004,Pedestrian,6,0,6
A & N ISLANDS,2004,Others (Please Specify),0,0,0
A & N ISLANDS,2004,Total Deaths (Persons),12,3,15
A & N ISLANDS,2004,Total Truck/Lorry,1,0,1
A & N ISLANDS,2004,Total Bus,0,1,1
A & N ISLANDS,2004,Total Tempo/Vans,0,0,0
A & N ISLANDS,2004,Total Jeep,1,0,1
A & N ISLANDS,2004,Total Car,0,0,0
A & N ISLANDS,2005,Truck/Lorry (Government),0,0,0
A & N ISLANDS,2005,Truck/Lorry (Private),3,0,3
A & N ISLANDS,2005,Bus (Government),4,3,7
A & N ISLANDS,2005,Bus (Private),5,1,6
A & N ISLANDS,2005,Tempo/Vans (Government),0,0,0
A & N ISLANDS,2005,Tempo/Vans (Private),0,0,0
A & N ISLANDS,2005,Jeep (Government),0,0,0
A & N ISLANDS,2005,Jeep (Private),0,0,0
A & N ISLANDS,2005,Car (Government),0,0,0
A & N ISLANDS,2005,Car (Private),1,1,2
A & N ISLANDS,2005,Three Wheeler,1,0,1
A & N ISLANDS,2005,Two Wheeler,4,0,4
A & N ISLANDS,2005,Bicycle,0,0,0
A & N ISLANDS,2005,Pedestrian,0,0,0
A & N ISLANDS,2005,Others (Please Specify),0,0,0
A & N ISLANDS,2005,Total Deaths (Persons),18,5,23
A & N ISLANDS,2005,Total Truck/Lorry,3,0,3
A & N ISLANDS,2005,Total Bus,9,4,13
A & N ISLANDS,2005,Total Tempo/Vans,0,0,0
A & N ISLANDS,2005,Total Jeep,0,0,0
A & N ISLANDS,2005,Total Car,1,1,2
A & N ISLANDS,2006,Truck/Lorry (Government),1,0,1
A & N ISLANDS,2006,Truck/Lorry (Private),11,1,12
A & N ISLANDS,2006,Bus (Government),0,0,0
A & N ISLANDS,2006,Bus (Private),6,0,6
A & N ISLANDS,2006,Tempo/Vans (Government),0,0,0
A & N ISLANDS,2006,Tempo/Vans (Private),0,0,0
A & N ISLANDS,2006,Jeep (Government),0,0,0
A & N ISLANDS,2006,Jeep (Private),1,0,1
A & N ISLANDS,2006,Car (Government),0,0,0
A & N ISLANDS,2006,Car (Private),0,0,0
A & N ISLANDS,2006,Three Wheeler,1,1,2
A & N ISLANDS,2006,Two Wheeler,0,0,0
A & N ISLANDS,2006,Bicycle,0,0,0
A & N ISLANDS,2006,Pedestrian,0,0,0
A & N ISLANDS,2006,Others (Please Specify),0,0,0
A & N ISLANDS,2006,Total Deaths (Persons),20,2,22
A & N ISLANDS,2006,Total Truck/Lorry,12,1,13
A & N ISLANDS,2006,Total Bus,6,0,6
A & N ISLANDS,2006,Total Tempo/Vans,0,0,0
A & N ISLANDS,2006,Total Jeep,1,0,1
A & N ISLANDS,2006,Total Car,0,0,0
A & N ISLANDS,2007,Truck/Lorry (Government),0,0,0
A & N ISLANDS,2007,Truck/Lorry (Private),3,0,3
A & N ISLANDS,2007,Bus (Government),0,0,0
A & N ISLANDS,2007,Bus (Private),0,0,0
A & N ISLANDS,2007,Tempo/Vans (Government),0,0,0
A & N ISLANDS,2007,Tempo/Vans (Private),0,0,0
A & N ISLANDS,2007,Jeep (Government),0,0,0
A & N ISLANDS,2007,Jeep (Private),1,0,1
A & N ISLANDS,2007,Car (Government),0,0,0
A & N ISLANDS,2007,Car (Private),0,1,1
A & N ISLANDS,2007,Three Wheeler,2,0,2
A & N ISLANDS,2007,Two Wheeler,7,0,7
A & N ISLANDS,2007,Bicycle,0,0,0
A & N ISLANDS,2007,Pedestrian,7,2,9
A & N ISLANDS,2007,Others (Please Specify),0,0,0
A & N ISLANDS,2007,Total Deaths (Persons),20,3,23
A & N ISLANDS,2007,Total Truck/Lorry,3,0,3
A & N ISLANDS,2007,Total Bus,0,0,0
A & N ISLANDS,2007,Total Tempo/Vans,0,0,0
A & N ISLANDS,2007,Total Jeep,1,0,1
A & N ISLANDS,2007,Total Car,0,1,1
A & N ISLANDS,2008,Truck/Lorry (Government),1,0,1
A & N ISLANDS,2008,Truck/Lorry (Private),4,1,5
A & N ISLANDS,2008,Bus (Government),0,0,0
A & N ISLANDS,2008,Bus (Private),1,0,1
A & N ISLANDS,2008,Tempo/Vans (Government),0,0,0
A & N ISLANDS,2008,Tempo/Vans (Private),2,0,2
A & N ISLANDS,2008,Jeep (Government),0,0,0
A & N ISLANDS,2008,Jeep (Private),1,2,3
A & N ISLANDS,2008,Car (Government),0,0,0
A & N ISLANDS,2008,Car (Private),1,0,1
A & N ISLANDS,2008,Three Wheeler,0,0,0
A & N ISLANDS,2008,Two Wheeler,5,0,5
A & N ISLANDS,2008,Bicycle,0,0,0
A & N ISLANDS,2008,Pedestrian,3,0,3
A & N ISLANDS,2008,Others (Please Specify),1,0,1
A & N ISLANDS,2008,Total Deaths (Persons),19,3,22
A & N ISLANDS,2008,Total Truck/Lorry,5,1,6
A & N ISLANDS,2008,Total Bus,1,0,1
A & N ISLANDS,2008,Total Tempo/Vans,2,0,2
A & N ISLANDS,2008,Total Jeep,1,2,3
A & N ISLANDS,2008,Total Car,1,0,1
A & N ISLANDS,2009,Truck/Lorry (Government),0,0,0
A & N ISLANDS,2009,Truck/Lorry (Private),4,0,4
A & N ISLANDS,2009,Bus (Government),1,0,1
A & N ISLANDS,2009,Bus (Private),6,0,6
A & N ISLANDS,2009,Tempo/Vans (Government),0,0,0
A & N ISLANDS,2009,Tempo/Vans (Private),0,0,0
A & N ISLANDS,2009,Jeep (Government),0,0,0
A & N ISLANDS,2009,Jeep (Private),2,0,2
A & N ISLANDS,2009,Car (Government),0,0,0
A & N ISLANDS,2009,Car (Private),6,1,7
A & N ISLANDS,2009,Three Wheeler,2,1,3
A & N ISLANDS,2009,Two Wheeler,7,2,9
A & N ISLANDS,2009,Bicycle,0,0,0
A & N ISLANDS,2009,Pedestrian,0,0,0
A & N ISLANDS,2009,Others (Please Specify),1,0,1
A & N ISLANDS,2009,Total Deaths (Persons),29,4,33
A & N ISLANDS,2009,Total Truck/Lorry,4,0,4
A & N ISLANDS,2009,Total Bus,7,0,7
A & N ISLANDS,2009,Total Tempo/Vans,0,0,0
A & N ISLANDS,2009,Total Jeep,2,0,2
A & N ISLANDS,2009,Total Car,6,1,7
A & N ISLANDS,2010,Truck/Lorry (Government),0,0,0
A & N ISLANDS,2010,Truck/Lorry (Private),4,0,4
A & N ISLANDS,2010,Bus (Government),0,0,0
A & N ISLANDS,2010,Bus (Private),1,0,1
A & N ISLANDS,2010,Tempo/Vans (Government),0,0,0
A & N ISLANDS,2010,Tempo/Vans (Private),0,0,0
A & N ISLANDS,2010,Jeep (Government),0,0,0
A & N ISLANDS,2010,Jeep (Private),1,0,1
A & N ISLANDS,2010,Car (Government),0,0,0
A & N ISLANDS,2010,Car (Private),3,0,3
A & N ISLANDS,2010,Three Wheeler,1,2,3
A & N ISLANDS,2010,Two Wheeler,9,2,11
A & N ISLANDS,2010,Bicycle,1,0,1
A & N ISLANDS,2010,Pedestrian,1,2,3
A & N ISLANDS,2010,Others (Please Specify),0,0,0
A & N ISLANDS,2010,Total Deaths (Persons),21,6,27
A & N ISLANDS,2010,Total Truck/Lorry,4,0,4
A & N ISLANDS,2010,Total Bus,1,0,1
A & N ISLANDS,2010,Total Tempo/Vans,0,0,0
A & N ISLANDS,2010,Total Jeep,1,0,1
A & N ISLANDS,2010,Total Car,3,0,3
A & N ISLANDS,2011,Truck/Lorry (Government),0,0,0
A & N ISLANDS,2011,Truck/Lorry (Private),0,0,0
A & N ISLANDS,2011,Bus (Government),0,0,0
A & N ISLANDS,2011,Bus (Private),1,0,1
A & N ISLANDS,2011,Tempo/Vans (Government),0,0,0
A & N ISLANDS,2011,Tempo/Vans (Private),0,0,0
A & N ISLANDS,2011,Jeep (Government),0,0,0
A & N ISLANDS,2011,Jeep (Private),2,0,2
A & N ISLANDS,2011,Car (Government),0,0,0
A & N ISLANDS,2011,Car (Private),0,0,0
A & N ISLANDS,2011,Three Wheeler,1,0,1
A & N ISLANDS,2011,Two Wheeler,6,1,7
A & N ISLANDS,2011,Bicycle,0,0,0
A & N ISLANDS,2011,Pedestrian,5,1,6
A & N ISLANDS,2011,Others (Please Specify),0,0,0
A & N ISLANDS,2011,Total Deaths (Persons),15,2,17
A & N ISLANDS,2011,Total Truck/Lorry,0,0,0
A & N ISLANDS,2011,Total Bus,1,0,1
A & N ISLANDS,2011,Total Tempo/Vans,0,0,0
A & N ISLANDS,2011,Total Jeep,2,0,2
A & N ISLANDS,2011,Total Car,0,0,0
A & N ISLANDS,2012,Truck/Lorry (Government),0,0,0
A & N ISLANDS,2012,Truck/Lorry (Private),3,0,3
A & N ISLANDS,2012,Bus (Government),0,0,0
A & N ISLANDS,2012,Bus (Private),0,0,0
A & N ISLANDS,2012,Tempo/Vans (Government),0,0,0
A & N ISLANDS,2012,Tempo/Vans (Private),0,0,0
A & N ISLANDS,2012,Jeep (Government),0,0,0
A & N ISLANDS,2012,Jeep (Private),1,0,1
A & N ISLANDS,2012,Car (Government),0,0,0
A & N ISLANDS,2012,Car (Private),0,0,0
A & N ISLANDS,2012,Three Wheeler,2,0,2
A & N ISLANDS,2012,Two Wheeler,7,3,10
A & N ISLANDS,2012,Bicycle,0,0,0
A & N ISLANDS,2012,Pedestrian,5,4,9
A & N ISLANDS,2012,Others (Please Specify),0,0,0
A & N ISLANDS,2012,Total Deaths (Persons),18,7,25
A & N ISLANDS,2012,Total Truck/Lorry,3,0,3
A & N ISLANDS,2012,Total Bus,0,0,0
A & N ISLANDS,2012,Total Tempo/Vans,0,0,0
A & N ISLANDS,2012,Total Jeep,1,0,1
A & N ISLANDS,2012,Total Car,0,0,0
CHANDIGARH,2001,Truck/Lorry (Government),0,0,0
CHANDIGARH,2001,Truck/Lorry (Private),3,0,3
CHANDIGARH,2001,Bus (Government),0,0,0
CHANDIGARH,2001,Bus (Private),0,1,1
CHANDIGARH,2001,Tempo/Vans (Government),0,0,0
CHANDIGARH,2001,Tempo/Vans (Private),0,0,0
CHANDIGARH,2001,Jeep (Government),1,0,1
CHANDIGARH,2001,Jeep (Private),0,0,0
CHANDIGARH,2001,Car (Government),1,0,1
CHANDIGARH,2001,Car (Private),4,0,4
CHANDIGARH,2001,Three Wheeler,1,0,1
CHANDIGARH,2001,Two Wheeler,38,11,49
CHANDIGARH,2001,Bicycle,24,4,28
CHANDIGARH,2001,Pedestrian,15,6,21
CHANDIGARH,2001,Others (Please Specify),7,2,9
CHANDIGARH,2001,Total Deaths (Persons),94,24,118
CHANDIGARH,2001,Total Truck/Lorry,3,0,3
CHANDIGARH,2001,Total Bus,0,1,1
CHANDIGARH,2001,Total Tempo/Vans,0,0,0
CHANDIGARH,2001,Total Jeep,1,0,1
CHANDIGARH,2001,Total Car,5,0,5
CHANDIGARH,2002,Truck/Lorry (Government),0,0,0
CHANDIGARH,2002,Truck/Lorry (Private),0,0,0
CHANDIGARH,2002,Bus (Government),0,0,0
CHANDIGARH,2002,Bus (Private),0,0,0
CHANDIGARH,2002,Tempo/Vans (Government),0,0,0
CHANDIGARH,2002,Tempo/Vans (Private),0,0,0
CHANDIGARH,2002,Jeep (Government),0,0,0
CHANDIGARH,2002,Jeep (Private),2,0,2
CHANDIGARH,2002,Car (Government),0,0,0
CHANDIGARH,2002,Car (Private),9,4,13
CHANDIGARH,2002,Three Wheeler,4,0,4
CHANDIGARH,2002,Two Wheeler,21,5,26
CHANDIGARH,2002,Bicycle,18,1,19
CHANDIGARH,2002,Pedestrian,33,6,39
CHANDIGARH,2002,Others (Please Specify),4,1,5
CHANDIGARH,2002,Total Deaths (Persons),91,17,108
CHANDIGARH,2002,Total Truck/Lorry,0,0,0
CHANDIGARH,2002,Total Bus,0,0,0
CHANDIGARH,2002,Total Tempo/Vans,0,0,0
CHANDIGARH,2002,Total Jeep,2,0,2
CHANDIGARH,2002,Total Car,9,4,13
CHANDIGARH,2003,Truck/Lorry (Government),0,0,0
CHANDIGARH,2003,Truck/Lorry (Private),0,0,0
CHANDIGARH,2003,Bus (Government),0,1,1
CHANDIGARH,2003,Bus (Private),0,0,0
CHANDIGARH,2003,Tempo/Vans (Government),0,0,0
CHANDIGARH,2003,Tempo/Vans (Private),0,0,0
CHANDIGARH,2003,Jeep (Government),0,0,0
CHANDIGARH,2003,Jeep (Private),0,0,0
CHANDIGARH,2003,Car (Government),0,0,0
CHANDIGARH,2003,Car (Private),1,3,4
CHANDIGARH,2003,Three Wheeler,4,0,4
CHANDIGARH,2003,Two Wheeler,48,7,55
CHANDIGARH,2003,Bicycle,24,2,26
CHANDIGARH,2003,Pedestrian,23,9,32
CHANDIGARH,2003,Others (Please Specify),7,5,12
CHANDIGARH,2003,Total Deaths (Persons),107,27,134
CHANDIGARH,2003,Total Truck/Lorry,0,0,0
CHANDIGARH,2003,Total Bus,0,1,1
CHANDIGARH,2003,Total Tempo/Vans,0,0,0
CHANDIGARH,2003,Total Jeep,0,0,0
CHANDIGARH,2003,Total Car,1,3,4
CHANDIGARH,2004,Truck/Lorry (Government),0,0,0
CHANDIGARH,2004,Truck/Lorry (Private),3,0,3
CHANDIGARH,2004,Bus (Government),0,1,1
CHANDIGARH,2004,Bus (Private),0,0,0
CHANDIGARH,2004,Tempo/Vans (Government),0,0,0
CHANDIGARH,2004,Tempo/Vans (Private),0,0,0
CHANDIGARH,2004,Jeep (Government),0,0,0
CHANDIGARH,2004,Jeep (Private),0,0,0
CHANDIGARH,2004,Car (Government),0,0,0
CHANDIGARH,2004,Car (Private),1,0,1
CHANDIGARH,2004,Three Wheeler,2,1,3
CHANDIGARH,2004,Two Wheeler,69,13,82
CHANDIGARH,2004,Bicycle,2,0,2
CHANDIGARH,2004,Pedestrian,20,4,24
CHANDIGARH,2004,Others (Please Specify),26,5,31
CHANDIGARH,2004,Total Deaths (Persons),123,24,147
CHANDIGARH,2004,Total Truck/Lorry,3,0,3
CHANDIGARH,2004,Total Bus,0,1,1
CHANDIGARH,2004,Total Tempo/Vans,0,0,0
CHANDIGARH,2004,Total Jeep,0,0,0
CHANDIGARH,2004,Total Car,1,0,1
CHANDIGARH,2005,Truck/Lorry (Government),0,0,0
CHANDIGARH,2005,Truck/Lorry (Private),0,0,0
CHANDIGARH,2005,Bus (Government),6,1,7
CHANDIGARH,2005,Bus (Private),0,0,0
CHANDIGARH,2005,Tempo/Vans (Government),0,0,0
CHANDIGARH,2005,Tempo/Vans (Private),0,0,0
CHANDIGARH,2005,Jeep (Government),1,0,1
CHANDIGARH,2005,Jeep (Private),0,0,0
CHANDIGARH,2005,Car (Government),0,0,0
CHANDIGARH,2005,Car (Private),2,2,4
CHANDIGARH,2005,Three Wheeler,2,0,2
CHANDIGARH,2005,Two Wheeler,49,6,55
CHANDIGARH,2005,Bicycle,20,3,23
CHANDIGARH,2005,Pedestrian,29,11,40
CHANDIGARH,2005,Others (Please Specify),2,0,2
CHANDIGARH,2005,Total Deaths (Persons),111,23,134
CHANDIGARH,2005,Total Truck/Lorry,0,0,0
CHANDIGARH,2005,Total Bus,6,1,7
CHANDIGARH,2005,Total Tempo/Vans,0,0,0
CHANDIGARH,2005,Total Jeep,1,0,1
CHANDIGARH,2005,Total Car,2,2,4
CHANDIGARH,2006,Truck/Lorry (Government),0,0,0
CHANDIGARH,2006,Truck/Lorry (Private),0,0,0
CHANDIGARH,2006,Bus (Government),0,0,0
CHANDIGARH,2006,Bus (Private),0,0,0
CHANDIGARH,2006,Tempo/Vans (Government),0,0,0
CHANDIGARH,2006,Tempo/Vans (Private),0,0,0
CHANDIGARH,2006,Jeep (Government),0,0,0
CHANDIGARH,2006,Jeep (Private),0,0,0
CHANDIGARH,2006,Car (Government),0,0,0
CHANDIGARH,2006,Car (Private),4,0,4
CHANDIGARH,2006,Three Wheeler,9,0,9
CHANDIGARH,2006,Two Wheeler,46,11,57
CHANDIGARH,2006,Bicycle,27,1,28
CHANDIGARH,2006,Pedestrian,30,9,39
CHANDIGARH,2006,Others (Please Specify),4,0,4
CHANDIGARH,2006,Total Deaths (Persons),120,21,141
CHANDIGARH,2006,Total Truck/Lorry,0,0,0
CHANDIGARH,2006,Total Bus,0,0,0
CHANDIGARH,2006,Total Tempo/Vans,0,0,0
CHANDIGARH,2006,Total Jeep,0,0,0
CHANDIGARH,2006,Total Car,4,0,4
CHANDIGARH,2007,Truck/Lorry (Government),0,0,0
CHANDIGARH,2007,Truck/Lorry (Private),0,0,0
CHANDIGARH,2007,Bus (Government),0,1,1
CHANDIGARH,2007,Bus (Private),0,0,0
CHANDIGARH,2007,Tempo/Vans (Government),0,0,0
CHANDIGARH,2007,Tempo/Vans (Private),2,0,2
CHANDIGARH,2007,Jeep (Government),0,0,0
CHANDIGARH,2007,Jeep (Private),0,0,0
CHANDIGARH,2007,Car (Government),0,0,0
CHANDIGARH,2007,Car (Private),7,1,8
CHANDIGARH,2007,Three Wheeler,1,1,2
CHANDIGARH,2007,Two Wheeler,63,6,69
CHANDIGARH,2007,Bicycle,21,3,24
CHANDIGARH,2007,Pedestrian,31,9,40
CHANDIGARH,2007,Others (Please Specify),5,0,5
CHANDIGARH,2007,Total Deaths (Persons),130,21,151
CHANDIGARH,2007,Total Truck/Lorry,0,0,0
CHANDIGARH,2007,Total Bus,0,1,1
CHANDIGARH,2007,Total Tempo/Vans,2,0,2
CHANDIGARH,2007,Total Jeep,0,0,0
CHANDIGARH,2007,Total Car,7,1,8
CHANDIGARH,2008,Truck/Lorry (Government),0,0,0
CHANDIGARH,2008,Truck/Lorry (Private),0,0,0
CHANDIGARH,2008,Bus (Government),0,0,0
CHANDIGARH,2008,Bus (Private),1,1,2
CHANDIGARH,2008,Tempo/Vans (Government),0,0,0
CHANDIGARH,2008,Tempo/Vans (Private),0,0,0
CHANDIGARH,2008,Jeep (Government),0,0,0
CHANDIGARH,2008,Jeep (Private),0,0,0
CHANDIGARH,2008,Car (Government),0,0,0
CHANDIGARH,2008,Car (Private),5,0,5
CHANDIGARH,2008,Three Wheeler,5,0,5
CHANDIGARH,2008,Two Wheeler,55,8,63
CHANDIGARH,2008,Bicycle,21,2,23
CHANDIGARH,2008,Pedestrian,31,12,43
CHANDIGARH,2008,Others (Please Specify),3,2,5
CHANDIGARH,2008,Total Deaths (Persons),121,25,146
CHANDIGARH,2008,Total Truck/Lorry,0,0,0
CHANDIGARH,2008,Total Bus,1,1,2
CHANDIGARH,2008,Total Tempo/Vans,0,0,0
CHANDIGARH,2008,Total Jeep,0,0,0
CHANDIGARH,2008,Total Car,5,0,5
CHANDIGARH,2009,Truck/Lorry (Government),0,0,0
CHANDIGARH,2009,Truck/Lorry (Private),0,0,0
CHANDIGARH,2009,Bus (Government),2,1,3
CHANDIGARH,2009,Bus (Private),1,0,1
CHANDIGARH,2009,Tempo/Vans (Government),0,0,0
CHANDIGARH,2009,Tempo/Vans (Private),0,0,0
CHANDIGARH,2009,Jeep (Government),0,0,0
CHANDIGARH,2009,Jeep (Private),0,0,0
CHANDIGARH,2009,Car (Government),0,0,0
CHANDIGARH,2009,Car (Private),3,0,3
CHANDIGARH,2009,Three Wheeler,3,1,4
CHANDIGARH,2009,Two Wheeler,64,7,71
CHANDIGARH,2009,Bicycle,25,0,25
CHANDIGARH,2009,Pedestrian,46,12,58
CHANDIGARH,2009,Others (Please Specify),4,2,6
CHANDIGARH,2009,Total Deaths (Persons),148,23,171
CHANDIGARH,2009,Total Truck/Lorry,0,0,0
CHANDIGARH,2009,Total Bus,3,1,4
CHANDIGARH,2009,Total Tempo/Vans,0,0,0
CHANDIGARH,2009,Total Jeep,0,0,0
CHANDIGARH,2009,Total Car,3,0,3
CHANDIGARH,2010,Truck/Lorry (Government),0,0,0
CHANDIGARH,2010,Truck/Lorry (Private),0,0,0
CHANDIGARH,2010,Bus (Government),0,0,0
CHANDIGARH,2010,Bus (Private),0,0,0
CHANDIGARH,2010,Tempo/Vans (Government),0,0,0
CHANDIGARH,2010,Tempo/Vans (Private),0,0,0
CHANDIGARH,2010,Jeep (Government),0,0,0
CHANDIGARH,2010,Jeep (Private),0,0,0
CHANDIGARH,2010,Car (Government),0,0,0
CHANDIGARH,2010,Car (Private),7,0,7
CHANDIGARH,2010,Three Wheeler,1,1,2
CHANDIGARH,2010,Two Wheeler,40,8,48
CHANDIGARH,2010,Bicycle,23,2,25
CHANDIGARH,2010,Pedestrian,40,12,52
CHANDIGARH,2010,Others (Please Specify),3,1,4
CHANDIGARH,2010,Total Deaths (Persons),114,24,138
CHANDIGARH,2010,Total Truck/Lorry,0,0,0
CHANDIGARH,2010,Total Bus,0,0,0
CHANDIGARH,2010,Total Tempo/Vans,0,0,0
CHANDIGARH,2010,Total Jeep,0,0,0
CHANDIGARH,2010,Total Car,7,0,7
CHANDIGARH,2011,Truck/Lorry (Government),0,0,0
CHANDIGARH,2011,Truck/Lorry (Private),0,0,0
CHANDIGARH,2011,Bus (Government),0,0,0
CHANDIGARH,2011,Bus (Private),0,0,0
CHANDIGARH,2011,Tempo/Vans (Government),0,0,0
CHANDIGARH,2011,Tempo/Vans (Private),0,0,0
CHANDIGARH,2011,Jeep (Government),0,0,0
CHANDIGARH,2011,Jeep (Private),0,0,0
CHANDIGARH,2011,Car (Government),0,0,0
CHANDIGARH,2011,Car (Private),6,2,8
CHANDIGARH,2011,Three Wheeler,2,0,2
CHANDIGARH,2011,Two Wheeler,44,6,50
CHANDIGARH,2011,Bicycle,20,2,22
CHANDIGARH,2011,Pedestrian,35,12,47
CHANDIGARH,2011,Others (Please Specify),7,0,7
CHANDIGARH,2011,Total Deaths (Persons),114,22,136
CHANDIGARH,2011,Total Truck/Lorry,0,0,0
CHANDIGARH,2011,Total Bus,0,0,0
CHANDIGARH,2011,Total Tempo/Vans,0,0,0
CHANDIGARH,2011,Total Jeep,0,0,0
CHANDIGARH,2011,Total Car,6,2,8
CHANDIGARH,2012,Truck/Lorry (Government),0,0,0
CHANDIGARH,2012,Truck/Lorry (Private),0,0,0
CHANDIGARH,2012,Bus (Government),0,0,0
CHANDIGARH,2012,Bus (Private),0,0,0
CHANDIGARH,2012,Tempo/Vans (Government),0,0,0
CHANDIGARH,2012,Tempo/Vans (Private),0,1,1
CHANDIGARH,2012,Jeep (Government),0,0,0
CHANDIGARH,2012,Jeep (Private),1,0,1
CHANDIGARH,2012,Car (Government),0,0,0
CHANDIGARH,2012,Car (Private),3,2,5
CHANDIGARH,2012,Three Wheeler,2,3,5
CHANDIGARH,2012,Two Wheeler,42,2,44
CHANDIGARH,2012,Bicycle,22,0,22
CHANDIGARH,2012,Pedestrian,26,6,32
CHANDIGARH,2012,Others (Please Specify),3,1,4
CHANDIGARH,2012,Total Deaths (Persons),99,15,114
CHANDIGARH,2012,Total Truck/Lorry,0,0,0
CHANDIGARH,2012,Total Bus,0,0,0
CHANDIGARH,2012,Total Tempo/Vans,0,1,1
CHANDIGARH,2012,Total Jeep,1,0,1
CHANDIGARH,2012,Total Car,3,2,5
D & N HAVELI,2001,Truck/Lorry (Government),0,0,0
D & N HAVELI,2001,Truck/Lorry (Private),5,2,7
D & N HAVELI,2001,Bus (Government),1,0,1
D & N HAVELI,2001,Bus (Private),0,0,0
D & N HAVELI,2001,Tempo/Vans (Government),0,0,0
D & N HAVELI,2001,Tempo/Vans (Private),2,1,3
D & N HAVELI,2001,Jeep (Government),0,0,0
D & N HAVELI,2001,Jeep (Private),0,0,0
D & N HAVELI,2001,Car (Government),0,0,0
D & N HAVELI,2001,Car (Private),1,0,1
D & N HAVELI,2001,Three Wheeler,1,2,3
D & N HAVELI,2001,Two Wheeler,6,0,6
D & N HAVELI,2001,Bicycle,4,0,4
D & N HAVELI,2001,Pedestrian,6,5,11
D & N HAVELI,2001,Others (Please Specify),1,0,1
D & N HAVELI,2001,Total Deaths (Persons),27,10,37
D & N HAVELI,2001,Total Truck/Lorry,5,2,7
D & N HAVELI,2001,Total Bus,1,0,1
D & N HAVELI,2001,Total Tempo/Vans,2,1,3
D & N HAVELI,2001,Total Jeep,0,0,0
D & N HAVELI,2001,Total Car,1,0,1
D & N HAVELI,2002,Truck/Lorry (Government),0,0,0
D & N HAVELI,2002,Truck/Lorry (Private),1,0,1
D & N HAVELI,2002,Bus (Government),0,0,0
D & N HAVELI,2002,Bus (Private),1,0,1
D & N HAVELI,2002,Tempo/Vans (Government),0,0,0
D & N HAVELI,2002,Tempo/Vans (Private),0,0,0
D & N HAVELI,2002,Jeep (Government),0,0,0
D & N HAVELI,2002,Jeep (Private),0,0,0
D & N HAVELI,2002,Car (Government),0,0,0
D & N HAVELI,2002,Car (Private),2,0,2
D & N HAVELI,2002,Three Wheeler,3,1,4
D & N HAVELI,2002,Two Wheeler,7,0,7
D & N HAVELI,2002,Bicycle,2,0,2
D & N HAVELI,2002,Pedestrian,8,4,12
D & N HAVELI,2002,Others (Please Specify),3,0,3
D & N HAVELI,2002,Total Deaths (Persons),27,5,32
D & N HAVELI,2002,Total Truck/Lorry,1,0,1
D & N HAVELI,2002,Total Bus,1,0,1
D & N HAVELI,2002,Total Tempo/Vans,0,0,0
D & N HAVELI,2002,Total Jeep,0,0,0
D & N HAVELI,2002,Total Car,2,0,2
D & N HAVELI,2003,Truck/Lorry (Government),0,0,0
D & N HAVELI,2003,Truck/Lorry (Private),2,0,2
D & N HAVELI,2003,Bus (Government),2,0,2
D & N HAVELI,2003,Bus (Private),1,0,1
D & N HAVELI,2003,Tempo/Vans (Government),0,0,0
D & N HAVELI,2003,Tempo/Vans (Private),4,1,5
D & N HAVELI,2003,Jeep (Government),0,0,0
D & N HAVELI,2003,Jeep (Private),4,0,4
D & N HAVELI,2003,Car (Government),0,0,0
D & N HAVELI,2003,Car (Private),2,0,2
D & N HAVELI,2003,Three Wheeler,3,0,3
D & N HAVELI,2003,Two Wheeler,4,0,4
D & N HAVELI,2003,Bicycle,3,0,3
D & N HAVELI,2003,Pedestrian,3,2,5
D & N HAVELI,2003,Others (Please Specify),3,0,3
D & N HAVELI,2003,Total Deaths (Persons),31,3,34
D & N HAVELI,2003,Total Truck/Lorry,2,0,2
D & N HAVELI,2003,Total Bus,3,0,3
D & N HAVELI,2003,Total Tempo/Vans,4,1,5
D & N HAVELI,2003,Total Jeep,4,0,4
D & N HAVELI,2003,Total Car,2,0,2
D & N HAVELI,2004,Truck/Lorry (Government),0,0,0
D & N HAVELI,2004,Truck/Lorry (Private),3,1,4
D & N HAVELI,2004,Bus (Government),0,0,0
D & N HAVELI,2004,Bus (Private),0,3,3
D & N HAVELI,2004,Tempo/Vans (Government),0,0,0
D & N HAVELI,2004,Tempo/Vans (Private),4,0,4
D & N HAVELI,2004,Jeep (Government),0,0,0
D & N HAVELI,2004,Jeep (Private),0,0,0
D & N HAVELI,2004,Car (Government),0,0,0
D & N HAVELI,2004,Car (Private),0,0,0
D & N HAVELI,2004,Three Wheeler,3,1,4
D & N HAVELI,2004,Two Wheeler,11,1,12
D & N HAVELI,2004,Bicycle,5,1,6
D & N HAVELI,2004,Pedestrian,11,1,12
D & N HAVELI,2004,Others (Please Specify),6,3,9
D & N HAVELI,2004,Total Deaths (Persons),43,11,54
D & N HAVELI,2004,Total Truck/Lorry,3,1,4
D & N HAVELI,2004,Total Bus,0,3,3
D & N HAVELI,2004,Total Tempo/Vans,4,0,4
D & N HAVELI,2004,Total Jeep,0,0,0
D & N HAVELI,2004,Total Car,0,0,0
D & N HAVELI,2005,Truck/Lorry (Government),0,0,0
D & N HAVELI,2005,Truck/Lorry (Private),18,2,20
D & N HAVELI,2005,Bus (Government),0,0,0
D & N HAVELI,2005,Bus (Private),0,0,0
D & N HAVELI,2005,Tempo/Vans (Government),0,0,0
D & N HAVELI,2005,Tempo/Vans (Private),3,0,3
D & N HAVELI,2005,Jeep (Government),0,0,0
D & N HAVELI,2005,Jeep (Private),5,1,6
D & N HAVELI,2005,Car (Government),0,0,0
D & N HAVELI,2005,Car (Private),4,0,4
D & N HAVELI,2005,Three Wheeler,2,0,2
D & N HAVELI,2005,Two Wheeler,10,3,13
D & N HAVELI,2005,Bicycle,0,0,0
D & N HAVELI,2005,Pedestrian,0,0,0
D & N HAVELI,2005,Others (Please Specify),7,0,7
D & N HAVELI,2005,Total Deaths (Persons),49,6,55
D & N HAVELI,2005,Total Truck/Lorry,18,2,20
D & N HAVELI,2005,Total Bus,0,0,0
D & N HAVELI,2005,Total Tempo/Vans,3,0,3
D & N HAVELI,2005,Total Jeep,5,1,6
D & N HAVELI,2005,Total Car,4,0,4
D & N HAVELI,2006,Truck/Lorry (Government),0,0,0
D & N HAVELI,2006,Truck/Lorry (Private),16,1,17
D & N HAVELI,2006,Bus (Government),3,0,3
D & N HAVELI,2006,Bus (Private),4,0,4
D & N HAVELI,2006,Tempo/Vans (Government),0,0,0
D & N HAVELI,2006,Tempo/Vans (Private),5,0,5
D & N HAVELI,2006,Jeep (Government),0,0,0
D & N HAVELI,2006,Jeep (Private),0,0,0
D & N HAVELI,2006,Car (Government),0,0,0
D & N HAVELI,2006,Car (Private),0,0,0
D & N HAVELI,2006,Three Wheeler,1,1,2
D & N HAVELI,2006,Two Wheeler,8,1,9
D & N HAVELI,2006,Bicycle,0,0,0
D & N HAVELI,2006,Pedestrian,0,0,0
D & N HAVELI,2006,Others (Please Specify),4,1,5
D & N HAVELI,2006,Total Deaths (Persons),41,4,45
D & N HAVELI,2006,Total Truck/Lorry,16,1,17
D & N HAVELI,2006,Total Bus,7,0,7
D & N HAVELI,2006,Total Tempo/Vans,5,0,5
D & N HAVELI,2006,Total Jeep,0,0,0
D & N HAVELI,2006,Total Car,0,0,0
D & N HAVELI,2007,Truck/Lorry (Government),0,0,0
D & N HAVELI,2007,Truck/Lorry (Private),16,0,16
D & N HAVELI,2007,Bus (Government),0,0,0
D & N HAVELI,2007,Bus (Private),3,0,3
D & N HAVELI,2007,Tempo/Vans (Government),0,0,0
D & N HAVELI,2007,Tempo/Vans (Private),11,0,11
D & N HAVELI,2007,Jeep (Government),0,0,0
D & N HAVELI,2007,Jeep (Private),1,0,1
D & N HAVELI,2007,Car (Government),0,0,0
D & N HAVELI,2007,Car (Private),2,0,2
D & N HAVELI,2007,Three Wheeler,3,3,6
D & N HAVELI,2007,Two Wheeler,19,0,19
D & N HAVELI,2007,Bicycle,0,0,0
D & N HAVELI,2007,Pedestrian,0,0,0
D & N HAVELI,2007,Others (Please Specify),8,0,8
D & N HAVELI,2007,Total Deaths (Persons),63,3,66
D & N HAVELI,2007,Total Truck/Lorry,16,0,16
D & N HAVELI,2007,Total Bus,3,0,3
D & N HAVELI,2007,Total Tempo/Vans,11,0,11
D & N HAVELI,2007,Total Jeep,1,0,1
D & N HAVELI,2007,Total Car,2,0,2
D & N HAVELI,2008,Truck/Lorry (Government),0,1,1
D & N HAVELI,2008,Truck/Lorry (Private),9,1,10
D & N HAVELI,2008,Bus (Government),0,0,0
D & N HAVELI,2008,Bus (Private),4,0,4
D & N HAVELI,2008,Tempo/Vans (Government),0,1,1
D & N HAVELI,2008,Tempo/Vans (Private),10,0,10
D & N HAVELI,2008,Jeep (Government),0,0,0
D & N HAVELI,2008,Jeep (Private),0,0,0
D & N HAVELI,2008,Car (Government),0,0,0
D & N HAVELI,2008,Car (Private),2,0,2
D & N HAVELI,2008,Three Wheeler,3,0,3
D & N HAVELI,2008,Two Wheeler,24,1,25
D & N HAVELI,2008,Bicycle,0,0,0
D & N HAVELI,2008,Pedestrian,4,0,4
D & N HAVELI,2008,Others (Please Specify),5,0,5
D & N HAVELI,2008,Total Deaths (Persons),61,4,65
D & N HAVELI,2008,Total Truck/Lorry,9,2,11
D & N HAVELI,2008,Total Bus,4,0,4
D & N HAVELI,2008,Total Tempo/Vans,10,1,11
D & N HAVELI,2008,Total Jeep,0,0,0
D & N HAVELI,2008,Total Car,2,0,2
D & N HAVELI,2009,Truck/Lorry (Government),0,0,0
D & N HAVELI,2009,Truck/Lorry (Private),0,0,0
D & N HAVELI,2009,Bus (Government),0,0,0
D & N HAVELI,2009,Bus (Private),0,0,0
D & N HAVELI,2009,Tempo/Vans (Government),0,0,0
D & N HAVELI,2009,Tempo/Vans (Private),0,0,0
D & N HAVELI,2009,Jeep (Government),0,0,0
D & N HAVELI,2009,Jeep (Private),0,0,0
D & N HAVELI,2009,Car (Government),0,0,0
D & N HAVELI,2009,Car (Private),4,0,4
D & N HAVELI,2009,Three Wheeler,2,0,2
D & N HAVELI,2009,Two Wheeler,18,4,22
D & N HAVELI,2009,Bicycle,5,0,5
D & N HAVELI,2009,Pedestrian,10,1,11
D & N HAVELI,2009,Others (Please Specify),1,0,1
D & N HAVELI,2009,Total Deaths (Persons),40,5,45
D & N HAVELI,2009,Total Truck/Lorry,0,0,0
D & N HAVELI,2009,Total Bus,0,0,0
D & N HAVELI,2009,Total Tempo/Vans,0,0,0
D & N HAVELI,2009,Total Jeep,0,0,0
D & N HAVELI,2009,Total Car,4,0,4
D & N HAVELI,2010,Truck/Lorry (Government),0,0,0
D & N HAVELI,2010,Truck/Lorry (Private),1,0,1
D & N HAVELI,2010,Bus (Government),0,0,0
D & N HAVELI,2010,Bus (Private),0,1,1
D & N HAVELI,2010,Tempo/Vans (Government),0,0,0
D & N HAVELI,2010,Tempo/Vans (Private),0,0,0
D & N HAVELI,2010,Jeep (Government),0,0,0
D & N HAVELI,2010,Jeep (Private),2,0,2
D & N HAVELI,2010,Car (Government),0,0,0
D & N HAVELI,2010,Car (Private),1,1,2
D & N HAVELI,2010,Three Wheeler,2,0,2
D & N HAVELI,2010,Two Wheeler,31,3,34
D & N HAVELI,2010,Bicycle,2,0,2
D & N HAVELI,2010,Pedestrian,10,1,11
D & N HAVELI,2010,Others (Please Specify),6,1,7
D & N HAVELI,2010,Total Deaths (Persons),55,7,62
D & N HAVELI,2010,Total Truck/Lorry,1,0,1
D & N HAVELI,2010,Total Bus,0,1,1
D & N HAVELI,2010,Total Tempo/Vans,0,0,0
D & N HAVELI,2010,Total Jeep,2,0,2
D & N HAVELI,2010,Total Car,1,1,2
D & N HAVELI,2011,Truck/Lorry (Government),0,0,0
D & N HAVELI,2011,Truck/Lorry (Private),2,0,2
D & N HAVELI,2011,Bus (Government),0,0,0
D & N HAVELI,2011,Bus (Private),0,0,0
D & N HAVELI,2011,Tempo/Vans (Government),0,0,0
D & N HAVELI,2011,Tempo/Vans (Private),0,0,0
D & N HAVELI,2011,Jeep (Government),0,0,0
D & N HAVELI,2011,Jeep (Private),0,0,0
D & N HAVELI,2011,Car (Government),0,0,0
D & N HAVELI,2011,Car (Private),4,0,4
D & N HAVELI,2011,Three Wheeler,2,1,3
D & N HAVELI,2011,Two Wheeler,23,5,28
D & N HAVELI,2011,Bicycle,2,1,3
D & N HAVELI,2011,Pedestrian,14,2,16
D & N HAVELI,2011,Others (Please Specify),7,0,7
D & N HAVELI,2011,Total Deaths (Persons),54,9,63
D & N HAVELI,2011,Total Truck/Lorry,2,0,2
D & N HAVELI,2011,Total Bus,0,0,0
D & N HAVELI,2011,Total Tempo/Vans,0,0,0
D & N HAVELI,2011,Total Jeep,0,0,0
D & N HAVELI,2011,Total Car,4,0,4
D & N HAVELI,2012,Truck/Lorry (Government),0,0,0
D & N HAVELI,2012,Truck/Lorry (Private),7,2,9
D & N HAVELI,2012,Bus (Government),1,0,1
D & N HAVELI,2012,Bus (Private),0,2,2
D & N HAVELI,2012,Tempo/Vans (Government),0,1,1
D & N HAVELI,2012,Tempo/Vans (Private),6,1,7
D & N HAVELI,2012,Jeep (Government),0,0,0
D & N HAVELI,2012,Jeep (Private),0,0,0
D & N HAVELI,2012,Car (Government),0,0,0
D & N HAVELI,2012,Car (Private),5,1,6
D & N HAVELI,2012,Three Wheeler,0,0,0
D & N HAVELI,2012,Two Wheeler,15,2,17
D & N HAVELI,2012,Bicycle,0,0,0
D & N HAVELI,2012,Pedestrian,0,0,0
D & N HAVELI,2012,Others (Please Specify),9,1,10
D & N HAVELI,2012,Total Deaths (Persons),43,10,53
D & N HAVELI,2012,Total Truck/Lorry,7,2,9
D & N HAVELI,2012,Total Bus,1,2,3
D & N HAVELI,2012,Total Tempo/Vans,6,2,8
D & N HAVELI,2012,Total Jeep,0,0,0
D & N HAVELI,2012,Total Car,5,1,6
DAMAN & DIU,2001,Truck/Lorry (Government),0,0,0
DAMAN & DIU,2001,Truck/Lorry (Private),0,0,0
DAMAN & DIU,2001,Bus (Government),0,0,0
DAMAN & DIU,2001,Bus (Private),0,0,0
DAMAN & DIU,2001,Tempo/Vans (Government),0,0,0
DAMAN & DIU,2001,Tempo/Vans (Private),0,0,0
DAMAN & DIU,2001,Jeep (Government),0,0,0
DAMAN & DIU,2001,Jeep (Private),0,0,0
DAMAN & DIU,2001,Car (Government),0,0,0
DAMAN & DIU,2001,Car (Private),0,0,0
DAMAN & DIU,2001,Three Wheeler,1,0,1
DAMAN & DIU,2001,Two Wheeler,1,0,1
DAMAN & DIU,2001,Bicycle,3,0,3
DAMAN & DIU,2001,Pedestrian,2,0,2
DAMAN & DIU,2001,Others (Please Specify),1,0,1
DAMAN & DIU,2001,Total Deaths (Persons),8,0,8
DAMAN & DIU,2001,Total Truck/Lorry,0,0,0
DAMAN & DIU,2001,Total Bus,0,0,0
DAMAN & DIU,2001,Total Tempo/Vans,0,0,0
DAMAN & DIU,2001,Total Jeep,0,0,0
DAMAN & DIU,2001,Total Car,0,0,0
DAMAN & DIU,2002,Truck/Lorry (Government),0,0,0
DAMAN & DIU,2002,Truck/Lorry (Private),0,0,0
DAMAN & DIU,2002,Bus (Government),0,0,0
DAMAN & DIU,2002,Bus (Private),0,0,0
DAMAN & DIU,2002,Tempo/Vans (Government),0,0,0
DAMAN & DIU,2002,Tempo/Vans (Private),0,0,0
DAMAN & DIU,2002,Jeep (Government),0,0,0
DAMAN & DIU,2002,Jeep (Private),0,0,0
DAMAN & DIU,2002,Car (Government),0,1,1
DAMAN & DIU,2002,Car (Private),0,0,0
DAMAN & DIU,2002,Three Wheeler,0,0,0
DAMAN & DIU,2002,Two Wheeler,11,1,12
DAMAN & DIU,2002,Bicycle,1,0,1
DAMAN & DIU,2002,Pedestrian,4,0,4
DAMAN & DIU,2002,Others (Please Specify),0,0,0
DAMAN & DIU,2002,Total Deaths (Persons),16,2,18
DAMAN & DIU,2002,Total Truck/Lorry,0,0,0
DAMAN & DIU,2002,Total Bus,0,0,0
DAMAN & DIU,2002,Total Tempo/Vans,0,0,0
DAMAN & DIU,2002,Total Jeep,0,0,0
DAMAN & DIU,2002,Total Car,0,1,1
DAMAN & DIU,2003,Truck/Lorry (Government),0,0,0
DAMAN & DIU,2003,Truck/Lorry (Private),0,0,0
DAMAN & DIU,2003,Bus (Government),0,0,0
DAMAN & DIU,2003,Bus (Private),0,0,0
DAMAN & DIU,2003,Tempo/Vans (Government),0,0,0
DAMAN & DIU,2003,Tempo/Vans (Private),0,0,0
DAMAN & DIU,2003,Jeep (Government),1,0,1
DAMAN & DIU,2003,Jeep (Private),0,0,0
DAMAN & DIU,2003,Car (Government),0,0,0
DAMAN & DIU,2003,Car (Private),0,0,0
DAMAN & DIU,2003,Three Wheeler,0,1,1
DAMAN & DIU,2003,Two Wheeler,6,1,7
DAMAN & DIU,2003,Bicycle,4,0,4
DAMAN & DIU,2003,Pedestrian,4,2,6
DAMAN & DIU,2003,Others (Please Specify),0,0,0
DAMAN & DIU,2003,Total Deaths (Persons),15,4,19
DAMAN & DIU,2003,Total Truck/Lorry,0,0,0
DAMAN & DIU,2003,Total Bus,0,0,0
DAMAN & DIU,2003,Total Tempo/Vans,0,0,0
DAMAN & DIU,2003,Total Jeep,1,0,1
DAMAN & DIU,2003,Total Car,0,0,0
DAMAN & DIU,2004,Truck/Lorry (Government),0,0,0
DAMAN & DIU,2004,Truck/Lorry (Private),6,0,6
DAMAN & DIU,2004,Bus (Government),0,0,0
DAMAN & DIU,2004,Bus (Private),0,0,0
DAMAN & DIU,2004,Tempo/Vans (Government),0,0,0
DAMAN & DIU,2004,Tempo/Vans (Private),3,0,3
DAMAN & DIU,2004,Jeep (Government),0,0,0
DAMAN & DIU,2004,Jeep (Private),0,0,0
DAMAN & DIU,2004,Car (Government),0,0,0
DAMAN & DIU,2004,Car (Private),3,0,3
DAMAN & DIU,2004,Three Wheeler,2,1,3
DAMAN & DIU,2004,Two Wheeler,6,0,6
DAMAN & DIU,2004,Bicycle,0,0,0
DAMAN & DIU,2004,Pedestrian,0,1,1
DAMAN & DIU,2004,Others (Please Specify),2,0,2
DAMAN & DIU,2004,Total Deaths (Persons),22,2,24
DAMAN & DIU,2004,Total Truck/Lorry,6,0,6
DAMAN & DIU,2004,Total Bus,0,0,0
DAMAN & DIU,2004,Total Tempo/Vans,3,0,3
DAMAN & DIU,2004,Total Jeep,0,0,0
DAMAN & DIU,2004,Total Car,3,0,3
DAMAN & DIU,2005,Truck/Lorry (Government),0,0,0
DAMAN & DIU,2005,Truck/Lorry (Private),2,0,2
DAMAN & DIU,2005,Bus (Government),0,0,0
DAMAN & DIU,2005,Bus (Private),0,0,0
DAMAN & DIU,2005,Tempo/Vans (Government),0,0,0
DAMAN & DIU,2005,Tempo/Vans (Private),2,0,2
DAMAN & DIU,2005,Jeep (Government),0,0,0
DAMAN & DIU,2005,Jeep (Private),0,0,0
DAMAN & DIU,2005,Car (Government),0,0,0
DAMAN & DIU,2005,Car (Private),5,0,5
DAMAN & DIU,2005,Three Wheeler,0,0,0
DAMAN & DIU,2005,Two Wheeler,10,1,11
DAMAN & DIU,2005,Bicycle,0,0,0
DAMAN & DIU,2005,Pedestrian,1,1,2
DAMAN & DIU,2005,Others (Please Specify),2,0,2
DAMAN & DIU,2005,Total Deaths (Persons),22,2,24
DAMAN & DIU,2005,Total Truck/Lorry,2,0,2
DAMAN & DIU,2005,Total Bus,0,0,0
DAMAN & DIU,2005,Total Tempo/Vans,2,0,2
DAMAN & DIU,2005,Total Jeep,0,0,0
DAMAN & DIU,2005,Total Car,5,0,5
DAMAN & DIU,2006,Truck/Lorry (Government),0,0,0
DAMAN & DIU,2006,Truck/Lorry (Private),0,0,0
DAMAN & DIU,2006,Bus (Government),0,0,0
DAMAN & DIU,2006,Bus (Private),1,0,1
DAMAN & DIU,2006,Tempo/Vans (Government),0,0,0
DAMAN & DIU,2006,Tempo/Vans (Private),0,0,0
DAMAN & DIU,2006,Jeep (Government),0,0,0
DAMAN & DIU,2006,Jeep (Private),0,0,0
DAMAN & DIU,2006,Car (Government),0,0,0
DAMAN & DIU,2006,Car (Private),0,0,0
DAMAN & DIU,2006,Three Wheeler,2,0,2
DAMAN & DIU,2006,Two Wheeler,12,0,12
DAMAN & DIU,2006,Bicycle,5,0,5
DAMAN & DIU,2006,Pedestrian,6,0,6
DAMAN & DIU,2006,Others (Please Specify),0,1,1
DAMAN & DIU,2006,Total Deaths (Persons),26,1,27
DAMAN & DIU,2006,Total Truck/Lorry,0,0,0
DAMAN & DIU,2006,Total Bus,1,0,1
DAMAN & DIU,2006,Total Tempo/Vans,0,0,0
DAMAN & DIU,2006,Total Jeep,0,0,0
DAMAN & DIU,2006,Total Car,0,0,0
DAMAN & DIU,2007,Truck/Lorry (Government),0,0,0
DAMAN & DIU,2007,Truck/Lorry (Private),0,0,0
DAMAN & DIU,2007,Bus (Government),0,0,0
DAMAN & DIU,2007,Bus (Private),1,0,1
DAMAN & DIU,2007,Tempo/Vans (Government),0,0,0
DAMAN & DIU,2007,Tempo/Vans (Private),0,0,0
DAMAN & DIU,2007,Jeep (Government),0,0,0
DAMAN & DIU,2007,Jeep (Private),0,0,0
DAMAN & DIU,2007,Car (Government),0,0,0
DAMAN & DIU,2007,Car (Private),1,0,1
DAMAN & DIU,2007,Three Wheeler,1,1,2
DAMAN & DIU,2007,Two Wheeler,14,0,14
DAMAN & DIU,2007,Bicycle,1,0,1
DAMAN & DIU,2007,Pedestrian,7,2,9
DAMAN & DIU,2007,Others (Please Specify),1,0,1
DAMAN & DIU,2007,Total Deaths (Persons),26,3,29
DAMAN & DIU,2007,Total Truck/Lorry,0,0,0
DAMAN & DIU,2007,Total Bus,1,0,1
DAMAN & DIU,2007,Total Tempo/Vans,0,0,0
DAMAN & DIU,2007,Total Jeep,0,0,0
DAMAN & DIU,2007,Total Car,1,0,1
DAMAN & DIU,2008,Truck/Lorry (Government),0,0,0
DAMAN & DIU,2008,Truck/Lorry (Private),0,0,0
DAMAN & DIU,2008,Bus (Government),0,0,0
DAMAN & DIU,2008,Bus (Private),0,0,0
DAMAN & DIU,2008,Tempo/Vans (Government),0,0,0
DAMAN & DIU,2008,Tempo/Vans (Private),0,0,0
DAMAN & DIU,2008,Jeep (Government),0,0,0
DAMAN & DIU,2008,Jeep (Private),0,0,0
DAMAN & DIU,2008,Car (Government),0,0,0
DAMAN & DIU,2008,Car (Private),2,0,2
DAMAN & DIU,2008,Three Wheeler,2,0,2
DAMAN & DIU,2008,Two Wheeler,8,0,8
DAMAN & DIU,2008,Bicycle,6,0,6
DAMAN & DIU,2008,Pedestrian,0,0,0
DAMAN & DIU,2008,Others (Please Specify),3,0,3
DAMAN & DIU,2008,Total Deaths (Persons),21,0,21
DAMAN & DIU,2008,Total Truck/Lorry,0,0,0
DAMAN & DIU,2008,Total Bus,0,0,0
DAMAN & DIU,2008,Total Tempo/Vans,0,0,0
DAMAN & DIU,2008,Total Jeep,0,0,0
DAMAN & DIU,2008,Total Car,2,0,2
DAMAN & DIU,2009,Truck/Lorry (Government),0,0,0
DAMAN & DIU,2009,Truck/Lorry (Private),0,0,0
DAMAN & DIU,2009,Bus (Government),0,0,0
DAMAN & DIU,2009,Bus (Private),0,0,0
DAMAN & DIU,2009,Tempo/Vans (Government),0,0,0
DAMAN & DIU,2009,Tempo/Vans (Private),0,0,0
DAMAN & DIU,2009,Jeep (Government),0,0,0
DAMAN & DIU,2009,Jeep (Private),0,0,0
DAMAN & DIU,2009,Car (Government),1,0,1
DAMAN & DIU,2009,Car (Private),1,0,1
DAMAN & DIU,2009,Three Wheeler,0,0,0
DAMAN & DIU,2009,Two Wheeler,11,0,11
DAMAN & DIU,2009,Bicycle,0,0,0
DAMAN & DIU,2009,Pedestrian,0,0,0
DAMAN & DIU,2009,Others (Please Specify),0,0,0
DAMAN & DIU,2009,Total Deaths (Persons),13,0,13
DAMAN & DIU,2009,Total Truck/Lorry,0,0,0
DAMAN & DIU,2009,Total Bus,0,0,0
DAMAN & DIU,2009,Total Tempo/Vans,0,0,0
DAMAN & DIU,2009,Total Jeep,0,0,0
DAMAN & DIU,2009,Total Car,2,0,2
DAMAN & DIU,2010,Truck/Lorry (Government),1,0,1
DAMAN & DIU,2010,Truck/Lorry (Private),0,0,0
DAMAN & DIU,2010,Bus (Government),0,0,0
DAMAN & DIU,2010,Bus (Private),0,0,0
DAMAN & DIU,2010,Tempo/Vans (Government),0,0,0
DAMAN & DIU,2010,Tempo/Vans (Private),0,0,0
DAMAN & DIU,2010,Jeep (Government),0,0,0
DAMAN & DIU,2010,Jeep (Private),0,0,0
DAMAN & DIU,2010,Car (Government),0,0,0
DAMAN & DIU,2010,Car (Private),0,0,0
DAMAN & DIU,2010,Three Wheeler,5,0,5
DAMAN & DIU,2010,Two Wheeler,9,2,11
DAMAN & DIU,2010,Bicycle,3,0,3
DAMAN & DIU,2010,Pedestrian,3,0,3
DAMAN & DIU,2010,Others (Please Specify),0,0,0
DAMAN & DIU,2010,Total Deaths (Persons),21,2,23
DAMAN & DIU,2010,Total Truck/Lorry,1,0,1
DAMAN & DIU,2010,Total Bus,0,0,0
DAMAN & DIU,2010,Total Tempo/Vans,0,0,0
DAMAN & DIU,2010,Total Jeep,0,0,0
DAMAN & DIU,2010,Total Car,0,0,0
DAMAN & DIU,2011,Truck/Lorry (Government),0,0,0
DAMAN & DIU,2011,Truck/Lorry (Private),3,0,3
DAMAN & DIU,2011,Bus (Government),0,0,0
DAMAN & DIU,2011,Bus (Private),2,0,2
DAMAN & DIU,2011,Tempo/Vans (Government),1,0,1
DAMAN & DIU,2011,Tempo/Vans (Private),1,0,1
DAMAN & DIU,2011,Jeep (Government),1,0,1
DAMAN & DIU,2011,Jeep (Private),1,0,1
DAMAN & DIU,2011,Car (Government),1,0,1
DAMAN & DIU,2011,Car (Private),1,0,1
DAMAN & DIU,2011,Three Wheeler,1,0,1
DAMAN & DIU,2011,Two Wheeler,1,0,1
DAMAN & DIU,2011,Bicycle,0,0,0
DAMAN & DIU,2011,Pedestrian,4,1,5
DAMAN & DIU,2011,Others (Please Specify),3,0,3
DAMAN & DIU,2011,Total Deaths (Persons),20,1,21
DAMAN & DIU,2011,Total Truck/Lorry,3,0,3
DAMAN & DIU,2011,Total Bus,2,0,2
DAMAN & DIU,2011,Total Tempo/Vans,2,0,2
DAMAN & DIU,2011,Total Jeep,2,0,2
DAMAN & DIU,2011,Total Car,2,0,2
DAMAN & DIU,2012,Truck/Lorry (Government),0,0,0
DAMAN & DIU,2012,Truck/Lorry (Private),0,0,0
DAMAN & DIU,2012,Bus (Government),0,0,0
DAMAN & DIU,2012,Bus (Private),1,0,1
DAMAN & DIU,2012,Tempo/Vans (Government),0,0,0
DAMAN & DIU,2012,Tempo/Vans (Private),0,0,0
DAMAN & DIU,2012,Jeep (Government),0,0,0
DAMAN & DIU,2012,Jeep (Private),0,0,0
DAMAN & DIU,2012,Car (Government),0,0,0
DAMAN & DIU,2012,Car (Private),3,0,3
DAMAN & DIU,2012,Three Wheeler,0,0,0
DAMAN & DIU,2012,Two Wheeler,15,1,16
DAMAN & DIU,2012,Bicycle,1,0,1
DAMAN & DIU,2012,Pedestrian,7,0,7
DAMAN & DIU,2012,Others (Please Specify),1,0,1
DAMAN & DIU,2012,Total Deaths (Persons),28,1,29
DAMAN & DIU,2012,Total Truck/Lorry,0,0,0
DAMAN & DIU,2012,Total Bus,1,0,1
DAMAN & DIU,2012,Total Tempo/Vans,0,0,0
DAMAN & DIU,2012,Total Jeep,0,0,0
DAMAN & DIU,2012,Total Car,3,0,3
DELHI (UT),2001,Truck/Lorry (Government),13,2,15
DELHI (UT),2001,Truck/Lorry (Private),120,17,137
DELHI (UT),2001,Bus (Government),34,10,44
DELHI (UT),2001,Bus (Private),154,31,185
DELHI (UT),2001,Tempo/Vans (Government),5,1,6
DELHI (UT),2001,Tempo/Vans (Private),90,16,106
DELHI (UT),2001,Jeep (Government),0,0,0
DELHI (UT),2001,Jeep (Private),12,1,13
DELHI (UT),2001,Car (Government),1,0,1
DELHI (UT),2001,Car (Private),101,16,117
DELHI (UT),2001,Three Wheeler,57,7,64
DELHI (UT),2001,Two Wheeler,312,42,354
DELHI (UT),2001,Bicycle,142,5,147
DELHI (UT),2001,Pedestrian,490,67,557
DELHI (UT),2001,Others (Please Specify),135,19,154
DELHI (UT),2001,Total Deaths (Persons),1666,234,1900
DELHI (UT),2001,Total Truck/Lorry,133,19,152
DELHI (UT),2001,Total Bus,188,41,229
DELHI (UT),2001,Total Tempo/Vans,95,17,112
DELHI (UT),2001,Total Jeep,12,1,13
DELHI (UT),2001,Total Car,102,16,118
DELHI (UT),2002,Truck/Lorry (Government),8,0,8
DELHI (UT),2002,Truck/Lorry (Private),92,7,99
DELHI (UT),2002,Bus (Government),17,4,21
DELHI (UT),2002,Bus (Private),96,20,116
DELHI (UT),2002,Tempo/Vans (Government),2,0,2
DELHI (UT),2002,Tempo/Vans (Private),73,18,91
DELHI (UT),2002,Jeep (Government),2,1,3
DELHI (UT),2002,Jeep (Private),15,2,17
DELHI (UT),2002,Car (Government),2,0,2
DELHI (UT),2002,Car (Private),85,17,102
DELHI (UT),2002,Three Wheeler,68,7,75
DELHI (UT),2002,Two Wheeler,366,34,400
DELHI (UT),2002,Bicycle,147,6,153
DELHI (UT),2002,Pedestrian,524,71,595
DELHI (UT),2002,Others (Please Specify),79,5,84
DELHI (UT),2002,Total Deaths (Persons),1576,192,1768
DELHI (UT),2002,Total Truck/Lorry,100,7,107
DELHI (UT),2002,Total Bus,113,24,137
DELHI (UT),2002,Total Tempo/Vans,75,18,93
DELHI (UT),2002,Total Jeep,17,3,20
DELHI (UT),2002,Total Car,87,17,104
DELHI (UT),2003,Truck/Lorry (Government),16,2,18
DELHI (UT),2003,Truck/Lorry (Private),108,14,122
DELHI (UT),2003,Bus (Government),20,2,22
DELHI (UT),2003,Bus (Private),141,22,163
DELHI (UT),2003,Tempo/Vans (Government),3,0,3
DELHI (UT),2003,Tempo/Vans (Private),91,16,107
DELHI (UT),2003,Jeep (Government),1,0,1
DELHI (UT),2003,Jeep (Private),17,0,17
DELHI (UT),2003,Car (Government),1,0,1
DELHI (UT),2003,Car (Private),85,21,106
DELHI (UT),2003,Three Wheeler,50,2,52
DELHI (UT),2003,Two Wheeler,365,37,402
DELHI (UT),2003,Bicycle,154,12,166
DELHI (UT),2003,Pedestrian,434,56,490
DELHI (UT),2003,Others (Please Specify),225,21,246
DELHI (UT),2003,Total Deaths (Persons),1711,205,1916
DELHI (UT),2003,Total Truck/Lorry,124,16,140
DELHI (UT),2003,Total Bus,161,24,185
DELHI (UT),2003,Total Tempo/Vans,94,16,110
DELHI (UT),2003,Total Jeep,18,0,18
DELHI (UT),2003,Total Car,86,21,107
DELHI (UT),2004,Truck/Lorry (Government),4,1,5
DELHI (UT),2004,Truck/Lorry (Private),124,14,138
DELHI (UT),2004,Bus (Government),26,2,28
DELHI (UT),2004,Bus (Private),123,26,149
DELHI (UT),2004,Tempo/Vans (Government),1,0,1
DELHI (UT),2004,Tempo/Vans (Private),87,1,88
DELHI (UT),2004,Jeep (Government),2,0,2
DELHI (UT),2004,Jeep (Private),19,3,22
DELHI (UT),2004,Car (Government),10,1,11
DELHI (UT),2004,Car (Private),107,13,120
DELHI (UT),2004,Three Wheeler,86,7,93
DELHI (UT),2004,Two Wheeler,338,35,373
DELHI (UT),2004,Bicycle,132,3,135
DELHI (UT),2004,Pedestrian,547,92,639
DELHI (UT),2004,Others (Please Specify),140,17,157
DELHI (UT),2004,Total Deaths (Persons),1746,215,1961
DELHI (UT),2004,Total Truck/Lorry,128,15,143
DELHI (UT),2004,Total Bus,149,28,177
DELHI (UT),2004,Total Tempo/Vans,88,1,89
DELHI (UT),2004,Total Jeep,21,3,24
DELHI (UT),2004,Total Car,117,14,131
DELHI (UT),2005,Truck/Lorry (Government),2,3,5
DELHI (UT),2005,Truck/Lorry (Private),132,10,142
DELHI (UT),2005,Bus (Government),34,6,40
DELHI (UT),2005,Bus (Private),109,24,133
DELHI (UT),2005,Tempo/Vans (Government),7,1,8
DELHI (UT),2005,Tempo/Vans (Private),77,9,86
DELHI (UT),2005,Jeep (Government),0,0,0
DELHI (UT),2005,Jeep (Private),12,4,16
DELHI (UT),2005,Car (Government),0,0,0
DELHI (UT),2005,Car (Private),107,16,123
DELHI (UT),2005,Three Wheeler,71,13,84
DELHI (UT),2005,Two Wheeler,435,36,471
DELHI (UT),2005,Bicycle,116,4,120
DELHI (UT),2005,Pedestrian,407,78,485
DELHI (UT),2005,Others (Please Specify),292,18,310
DELHI (UT),2005,Total Deaths (Persons),1801,222,2023
DELHI (UT),2005,Total Truck/Lorry,134,13,147
DELHI (UT),2005,Total Bus,143,30,173
DELHI (UT),2005,Total Tempo/Vans,84,10,94
DELHI (UT),2005,Total Jeep,12,4,16
DELHI (UT),2005,Total Car,107,16,123
DELHI (UT),2006,Truck/Lorry (Government),6,1,7
DELHI (UT),2006,Truck/Lorry (Private),123,8,131
DELHI (UT),2006,Bus (Government),35,1,36
DELHI (UT),2006,Bus (Private),111,15,126
DELHI (UT),2006,Tempo/Vans (Government),0,0,0
DELHI (UT),2006,Tempo/Vans (Private),92,13,105
DELHI (UT),2006,Jeep (Government),2,0,2
DELHI (UT),2006,Jeep (Private),19,3,22
DELHI (UT),2006,Car (Government),0,0,0
DELHI (UT),2006,Car (Private),129,25,154
DELHI (UT),2006,Three Wheeler,68,8,76
DELHI (UT),2006,Two Wheeler,491,34,525
DELHI (UT),2006,Bicycle,91,1,92
DELHI (UT),2006,Pedestrian,618,74,692
DELHI (UT),2006,Others (Please Specify),185,14,199
DELHI (UT),2006,Total Deaths (Persons),1970,197,2167
DELHI (UT),2006,Total Truck/Lorry,129,9,138
DELHI (UT),2006,Total Bus,146,16,162
DELHI (UT),2006,Total Tempo/Vans,92,13,105
DELHI (UT),2006,Total Jeep,21,3,24
DELHI (UT),2006,Total Car,129,25,154
DELHI (UT),2007,Truck/Lorry (Government),2,1,3
DELHI (UT),2007,Truck/Lorry (Private),118,9,127
DELHI (UT),2007,Bus (Government),33,4,37
DELHI (UT),2007,Bus (Private),117,16,133
DELHI (UT),2007,Tempo/Vans (Government),3,1,4
DELHI (UT),2007,Tempo/Vans (Private),84,7,91
DELHI (UT),2007,Jeep (Government),3,1,4
DELHI (UT),2007,Jeep (Private),14,2,16
DELHI (UT),2007,Car (Government),4,1,5
DELHI (UT),2007,Car (Private),140,32,172
DELHI (UT),2007,Three Wheeler,63,8,71
DELHI (UT),2007,Two Wheeler,489,44,533
DELHI (UT),2007,Bicycle,106,2,108
DELHI (UT),2007,Pedestrian,504,59,563
DELHI (UT),2007,Others (Please Specify),241,14,255
DELHI (UT),2007,Total Deaths (Persons),1921,201,2122
DELHI (UT),2007,Total Truck/Lorry,120,10,130
DELHI (UT),2007,Total Bus,150,20,170
DELHI (UT),2007,Total Tempo/Vans,87,8,95
DELHI (UT),2007,Total Jeep,17,3,20
DELHI (UT),2007,Total Car,144,33,177
DELHI (UT),2008,Truck/Lorry (Government),3,0,3
DELHI (UT),2008,Truck/Lorry (Private),157,13,170
DELHI (UT),2008,Bus (Government),16,7,23
DELHI (UT),2008,Bus (Private),94,16,110
DELHI (UT),2008,Tempo/Vans (Government),1,0,1
DELHI (UT),2008,Tempo/Vans (Private),102,7,109
DELHI (UT),2008,Jeep (Government),0,0,0
DELHI (UT),2008,Jeep (Private),8,2,10
DELHI (UT),2008,Car (Government),1,2,3
DELHI (UT),2008,Car (Private),124,24,148
DELHI (UT),2008,Three Wheeler,74,5,79
DELHI (UT),2008,Two Wheeler,507,47,554
DELHI (UT),2008,Bicycle,68,1,69
DELHI (UT),2008,Pedestrian,517,72,589
DELHI (UT),2008,Others (Please Specify),212,18,230
DELHI (UT),2008,Total Deaths (Persons),1884,214,2098
DELHI (UT),2008,Total Truck/Lorry,160,13,173
DELHI (UT),2008,Total Bus,110,23,133
DELHI (UT),2008,Total Tempo/Vans,103,7,110
DELHI (UT),2008,Total Jeep,8,2,10
DELHI (UT),2008,Total Car,125,26,151
DELHI (UT),2009,Truck/Lorry (Government),9,1,10
DELHI (UT),2009,Truck/Lorry (Private),108,13,121
DELHI (UT),2009,Bus (Government),19,5,24
DELHI (UT),2009,Bus (Private),47,10,57
DELHI (UT),2009,Tempo/Vans (Government),2,0,2
DELHI (UT),2009,Tempo/Vans (Private),62,10,72
DELHI (UT),2009,Jeep (Government),0,0,0
DELHI (UT),2009,Jeep (Private),14,1,15
DELHI (UT),2009,Car (Government),1,1,2
DELHI (UT),2009,Car (Private),121,17,138
DELHI (UT),2009,Three Wheeler,55,5,60
DELHI (UT),2009,Two Wheeler,662,51,713
DELHI (UT),2009,Bicycle,140,6,146
DELHI (UT),2009,Pedestrian,442,58,500
DELHI (UT),2009,Others (Please Specify),158,9,167
DELHI (UT),2009,Total Deaths (Persons),1840,187,2027
DELHI (UT),2009,Total Truck/Lorry,117,14,131
DELHI (UT),2009,Total Bus,66,15,81
DELHI (UT),2009,Total Tempo/Vans,64,10,74
DELHI (UT),2009,Total Jeep,14,1,15
DELHI (UT),2009,Total Car,122,18,140
DELHI (UT),2010,Truck/Lorry (Government),3,1,4
DELHI (UT),2010,Truck/Lorry (Private),131,14,145
DELHI (UT),2010,Bus (Government),20,5,25
DELHI (UT),2010,Bus (Private),66,7,73
DELHI (UT),2010,Tempo/Vans (Government),3,0,3
DELHI (UT),2010,Tempo/Vans (Private),85,8,93
DELHI (UT),2010,Jeep (Government),2,0,2
DELHI (UT),2010,Jeep (Private),16,1,17
DELHI (UT),2010,Car (Government),1,3,4
DELHI (UT),2010,Car (Private),193,21,214
DELHI (UT),2010,Three Wheeler,77,10,87
DELHI (UT),2010,Two Wheeler,611,53,664
DELHI (UT),2010,Bicycle,95,10,105
DELHI (UT),2010,Pedestrian,481,53,534
DELHI (UT),2010,Others (Please Specify),180,20,200
DELHI (UT),2010,Total Deaths (Persons),1964,206,2170
DELHI (UT),2010,Total Truck/Lorry,134,15,149
DELHI (UT),2010,Total Bus,86,12,98
DELHI (UT),2010,Total Tempo/Vans,88,8,96
DELHI (UT),2010,Total Jeep,18,1,19
DELHI (UT),2010,Total Car,194,24,218
DELHI (UT),2011,Truck/Lorry (Government),9,2,11
DELHI (UT),2011,Truck/Lorry (Private),117,13,130
DELHI (UT),2011,Bus (Government),37,11,48
DELHI (UT),2011,Bus (Private),37,7,44
DELHI (UT),2011,Tempo/Vans (Government),3,0,3
DELHI (UT),2011,Tempo/Vans (Private),79,7,86
DELHI (UT),2011,Jeep (Government),0,0,0
DELHI (UT),2011,Jeep (Private),17,2,19
DELHI (UT),2011,Car (Government),1,0,1
DELHI (UT),2011,Car (Private),161,24,185
DELHI (UT),2011,Three Wheeler,58,6,64
DELHI (UT),2011,Two Wheeler,583,59,642
DELHI (UT),2011,Bicycle,76,0,76
DELHI (UT),2011,Pedestrian,517,86,603
DELHI (UT),2011,Others (Please Specify),184,11,195
DELHI (UT),2011,Total Deaths (Persons),1879,228,2107
DELHI (UT),2011,Total Truck/Lorry,126,15,141
DELHI (UT),2011,Total Bus,74,18,92
DELHI (UT),2011,Total Tempo/Vans,82,7,89
DELHI (UT),2011,Total Jeep,17,2,19
DELHI (UT),2011,Total Car,162,24,186
DELHI (UT),2012,Truck/Lorry (Government),2,0,2
DELHI (UT),2012,Truck/Lorry (Private),112,17,129
DELHI (UT),2012,Bus (Government),24,7,31
DELHI (UT),2012,Bus (Private),29,5,34
DELHI (UT),2012,Tempo/Vans (Government),1,0,1
DELHI (UT),2012,Tempo/Vans (Private),89,9,98
DELHI (UT),2012,Jeep (Government),1,0,1
DELHI (UT),2012,Jeep (Private),11,0,11
DELHI (UT),2012,Car (Government),4,1,5
DELHI (UT),2012,Car (Private),187,13,200
DELHI (UT),2012,Three Wheeler,58,9,67
DELHI (UT),2012,Two Wheeler,453,36,489
DELHI (UT),2012,Bicycle,77,1,78
DELHI (UT),2012,Pedestrian,449,52,501
DELHI (UT),2012,Others (Please Specify),201,18,219
DELHI (UT),2012,Total Deaths (Persons),1698,168,1866
DELHI (UT),2012,Total Truck/Lorry,114,17,131
DELHI (UT),2012,Total Bus,53,12,65
DELHI (UT),2012,Total Tempo/Vans,90,9,99
DELHI (UT),2012,Total Jeep,12,0,12
DELHI (UT),2012,Total Car,191,14,205
LAKSHADWEEP,2001,Truck/Lorry (Government),0,0,0
LAKSHADWEEP,2001,Truck/Lorry (Private),0,0,0
LAKSHADWEEP,2001,Bus (Government),0,0,0
LAKSHADWEEP,2001,Bus (Private),0,0,0
LAKSHADWEEP,2001,Tempo/Vans (Government),0,0,0
LAKSHADWEEP,2001,Tempo/Vans (Private),0,0,0
LAKSHADWEEP,2001,Jeep (Government),0,0,0
LAKSHADWEEP,2001,Jeep (Private),0,0,0
LAKSHADWEEP,2001,Car (Government),0,0,0
LAKSHADWEEP,2001,Car (Private),0,0,0
LAKSHADWEEP,2001,Three Wheeler,0,0,0
LAKSHADWEEP,2001,Two Wheeler,1,0,1
LAKSHADWEEP,2001,Bicycle,0,0,0
LAKSHADWEEP,2001,Pedestrian,0,0,0
LAKSHADWEEP,2001,Others (Please Specify),0,0,0
LAKSHADWEEP,2001,Total Deaths (Persons),1,0,1
LAKSHADWEEP,2001,Total Truck/Lorry,0,0,0
LAKSHADWEEP,2001,Total Bus,0,0,0
LAKSHADWEEP,2001,Total Tempo/Vans,0,0,0
LAKSHADWEEP,2001,Total Jeep,0,0,0
LAKSHADWEEP,2001,Total Car,0,0,0
LAKSHADWEEP,2002,Truck/Lorry (Government),0,0,0
LAKSHADWEEP,2002,Truck/Lorry (Private),0,0,0
LAKSHADWEEP,2002,Bus (Government),0,0,0
LAKSHADWEEP,2002,Bus (Private),0,0,0
LAKSHADWEEP,2002,Tempo/Vans (Government),0,0,0
LAKSHADWEEP,2002,Tempo/Vans (Private),0,0,0
LAKSHADWEEP,2002,Jeep (Government),0,0,0
LAKSHADWEEP,2002,Jeep (Private),0,0,0
LAKSHADWEEP,2002,Car (Government),0,0,0
LAKSHADWEEP,2002,Car (Private),0,0,0
LAKSHADWEEP,2002,Three Wheeler,0,0,0
LAKSHADWEEP,2002,Two Wheeler,0,0,0
LAKSHADWEEP,2002,Bicycle,0,0,0
LAKSHADWEEP,2002,Pedestrian,0,0,0
LAKSHADWEEP,2002,Others (Please Specify),0,0,0
LAKSHADWEEP,2002,Total Deaths (Persons),0,0,0
LAKSHADWEEP,2002,Total Truck/Lorry,0,0,0
LAKSHADWEEP,2002,Total Bus,0,0,0
LAKSHADWEEP,2002,Total Tempo/Vans,0,0,0
LAKSHADWEEP,2002,Total Jeep,0,0,0
LAKSHADWEEP,2002,Total Car,0,0,0
LAKSHADWEEP,2003,Truck/Lorry (Government),0,0,0
LAKSHADWEEP,2003,Truck/Lorry (Private),0,0,0
LAKSHADWEEP,2003,Bus (Government),0,0,0
LAKSHADWEEP,2003,Bus (Private),0,0,0
LAKSHADWEEP,2003,Tempo/Vans (Government),0,0,0
LAKSHADWEEP,2003,Tempo/Vans (Private),0,0,0
LAKSHADWEEP,2003,Jeep (Government),0,0,0
LAKSHADWEEP,2003,Jeep (Private),0,0,0
LAKSHADWEEP,2003,Car (Government),0,0,0
LAKSHADWEEP,2003,Car (Private),0,0,0
LAKSHADWEEP,2003,Three Wheeler,0,0,0
LAKSHADWEEP,2003,Two Wheeler,1,0,1
LAKSHADWEEP,2003,Bicycle,0,0,0
LAKSHADWEEP,2003,Pedestrian,0,0,0
LAKSHADWEEP,2003,Others (Please Specify),0,0,0
LAKSHADWEEP,2003,Total Deaths (Persons),1,0,1
LAKSHADWEEP,2003,Total Truck/Lorry,0,0,0
LAKSHADWEEP,2003,Total Bus,0,0,0
LAKSHADWEEP,2003,Total Tempo/Vans,0,0,0
LAKSHADWEEP,2003,Total Jeep,0,0,0
LAKSHADWEEP,2003,Total Car,0,0,0
LAKSHADWEEP,2004,Truck/Lorry (Government),0,0,0
LAKSHADWEEP,2004,Truck/Lorry (Private),0,0,0
LAKSHADWEEP,2004,Bus (Government),0,0,0
LAKSHADWEEP,2004,Bus (Private),0,0,0
LAKSHADWEEP,2004,Tempo/Vans (Government),0,0,0
LAKSHADWEEP,2004,Tempo/Vans (Private),0,0,0
LAKSHADWEEP,2004,Jeep (Government),0,0,0
LAKSHADWEEP,2004,Jeep (Private),0,0,0
LAKSHADWEEP,2004,Car (Government),0,0,0
LAKSHADWEEP,2004,Car (Private),0,0,0
LAKSHADWEEP,2004,Three Wheeler,0,0,0
LAKSHADWEEP,2004,Two Wheeler,0,0,0
LAKSHADWEEP,2004,Bicycle,0,0,0
LAKSHADWEEP,2004,Pedestrian,0,0,0
LAKSHADWEEP,2004,Others (Please Specify),0,0,0
LAKSHADWEEP,2004,Total Deaths (Persons),0,0,0
LAKSHADWEEP,2004,Total Truck/Lorry,0,0,0
LAKSHADWEEP,2004,Total Bus,0,0,0
LAKSHADWEEP,2004,Total Tempo/Vans,0,0,0
LAKSHADWEEP,2004,Total Jeep,0,0,0
LAKSHADWEEP,2004,Total Car,0,0,0
LAKSHADWEEP,2005,Truck/Lorry (Government),0,0,0
LAKSHADWEEP,2005,Truck/Lorry (Private),0,0,0
LAKSHADWEEP,2005,Bus (Government),0,0,0
LAKSHADWEEP,2005,Bus (Private),0,0,0
LAKSHADWEEP,2005,Tempo/Vans (Government),0,0,0
LAKSHADWEEP,2005,Tempo/Vans (Private),0,0,0
LAKSHADWEEP,2005,Jeep (Government),0,0,0
LAKSHADWEEP,2005,Jeep (Private),0,0,0
LAKSHADWEEP,2005,Car (Government),0,0,0
LAKSHADWEEP,2005,Car (Private),0,0,0
LAKSHADWEEP,2005,Three Wheeler,0,0,0
LAKSHADWEEP,2005,Two Wheeler,0,0,0
LAKSHADWEEP,2005,Bicycle,0,0,0
LAKSHADWEEP,2005,Pedestrian,0,0,0
LAKSHADWEEP,2005,Others (Please Specify),0,0,0
LAKSHADWEEP,2005,Total Deaths (Persons),0,0,0
LAKSHADWEEP,2005,Total Truck/Lorry,0,0,0
LAKSHADWEEP,2005,Total Bus,0,0,0
LAKSHADWEEP,2005,Total Tempo/Vans,0,0,0
LAKSHADWEEP,2005,Total Jeep,0,0,0
LAKSHADWEEP,2005,Total Car,0,0,0
LAKSHADWEEP,2006,Truck/Lorry (Government),0,0,0
LAKSHADWEEP,2006,Truck/Lorry (Private),0,0,0
LAKSHADWEEP,2006,Bus (Government),0,0,0
LAKSHADWEEP,2006,Bus (Private),0,0,0
LAKSHADWEEP,2006,Tempo/Vans (Government),0,0,0
LAKSHADWEEP,2006,Tempo/Vans (Private),0,0,0
LAKSHADWEEP,2006,Jeep (Government),0,0,0
LAKSHADWEEP,2006,Jeep (Private),0,0,0
LAKSHADWEEP,2006,Car (Government),0,0,0
LAKSHADWEEP,2006,Car (Private),0,0,0
LAKSHADWEEP,2006,Three Wheeler,0,0,0
LAKSHADWEEP,2006,Two Wheeler,1,0,1
LAKSHADWEEP,2006,Bicycle,0,0,0
LAKSHADWEEP,2006,Pedestrian,0,0,0
LAKSHADWEEP,2006,Others (Please Specify),0,0,0
LAKSHADWEEP,2006,Total Deaths (Persons),1,0,1
LAKSHADWEEP,2006,Total Truck/Lorry,0,0,0
LAKSHADWEEP,2006,Total Bus,0,0,0
LAKSHADWEEP,2006,Total Tempo/Vans,0,0,0
LAKSHADWEEP,2006,Total Jeep,0,0,0
LAKSHADWEEP,2006,Total Car,0,0,0
LAKSHADWEEP,2007,Truck/Lorry (Government),0,0,0
LAKSHADWEEP,2007,Truck/Lorry (Private),0,0,0
LAKSHADWEEP,2007,Bus (Government),0,0,0
LAKSHADWEEP,2007,Bus (Private),0,0,0
LAKSHADWEEP,2007,Tempo/Vans (Government),0,0,0
LAKSHADWEEP,2007,Tempo/Vans (Private),0,0,0
LAKSHADWEEP,2007,Jeep (Government),0,0,0
LAKSHADWEEP,2007,Jeep (Private),0,0,0
LAKSHADWEEP,2007,Car (Government),0,0,0
LAKSHADWEEP,2007,Car (Private),0,0,0
LAKSHADWEEP,2007,Three Wheeler,0,0,0
LAKSHADWEEP,2007,Two Wheeler,0,0,0
LAKSHADWEEP,2007,Bicycle,0,0,0
LAKSHADWEEP,2007,Pedestrian,0,0,0
LAKSHADWEEP,2007,Others (Please Specify),0,0,0
LAKSHADWEEP,2007,Total Deaths (Persons),0,0,0
LAKSHADWEEP,2007,Total Truck/Lorry,0,0,0
LAKSHADWEEP,2007,Total Bus,0,0,0
LAKSHADWEEP,2007,Total Tempo/Vans,0,0,0
LAKSHADWEEP,2007,Total Jeep,0,0,0
LAKSHADWEEP,2007,Total Car,0,0,0
LAKSHADWEEP,2008,Truck/Lorry (Government),0,0,0
LAKSHADWEEP,2008,Truck/Lorry (Private),0,0,0
LAKSHADWEEP,2008,Bus (Government),0,0,0
LAKSHADWEEP,2008,Bus (Private),0,0,0
LAKSHADWEEP,2008,Tempo/Vans (Government),0,0,0
LAKSHADWEEP,2008,Tempo/Vans (Private),0,0,0
LAKSHADWEEP,2008,Jeep (Government),0,0,0
LAKSHADWEEP,2008,Jeep (Private),0,0,0
LAKSHADWEEP,2008,Car (Government),0,0,0
LAKSHADWEEP,2008,Car (Private),0,0,0
LAKSHADWEEP,2008,Three Wheeler,0,0,0
LAKSHADWEEP,2008,Two Wheeler,0,0,0
LAKSHADWEEP,2008,Bicycle,0,0,0
LAKSHADWEEP,2008,Pedestrian,0,0,0
LAKSHADWEEP,2008,Others (Please Specify),0,0,0
LAKSHADWEEP,2008,Total Deaths (Persons),0,0,0
LAKSHADWEEP,2008,Total Truck/Lorry,0,0,0
LAKSHADWEEP,2008,Total Bus,0,0,0
LAKSHADWEEP,2008,Total Tempo/Vans,0,0,0
LAKSHADWEEP,2008,Total Jeep,0,0,0
LAKSHADWEEP,2008,Total Car,0,0,0
LAKSHADWEEP,2009,Truck/Lorry (Government),0,0,0
LAKSHADWEEP,2009,Truck/Lorry (Private),0,0,0
LAKSHADWEEP,2009,Bus (Government),0,0,0
LAKSHADWEEP,2009,Bus (Private),0,0,0
LAKSHADWEEP,2009,Tempo/Vans (Government),0,0,0
LAKSHADWEEP,2009,Tempo/Vans (Private),0,0,0
LAKSHADWEEP,2009,Jeep (Government),0,0,0
LAKSHADWEEP,2009,Jeep (Private),0,0,0
LAKSHADWEEP,2009,Car (Government),0,0,0
LAKSHADWEEP,2009,Car (Private),0,0,0
LAKSHADWEEP,2009,Three Wheeler,0,0,0
LAKSHADWEEP,2009,Two Wheeler,2,0,2
LAKSHADWEEP,2009,Bicycle,0,0,0
LAKSHADWEEP,2009,Pedestrian,0,0,0
LAKSHADWEEP,2009,Others (Please Specify),0,0,0
LAKSHADWEEP,2009,Total Deaths (Persons),2,0,2
LAKSHADWEEP,2009,Total Truck/Lorry,0,0,0
LAKSHADWEEP,2009,Total Bus,0,0,0
LAKSHADWEEP,2009,Total Tempo/Vans,0,0,0
LAKSHADWEEP,2009,Total Jeep,0,0,0
LAKSHADWEEP,2009,Total Car,0,0,0
LAKSHADWEEP,2010,Truck/Lorry (Government),0,0,0
LAKSHADWEEP,2010,Truck/Lorry (Private),0,0,0
LAKSHADWEEP,2010,Bus (Government),0,0,0
LAKSHADWEEP,2010,Bus (Private),0,0,0
LAKSHADWEEP,2010,Tempo/Vans (Government),0,0,0
LAKSHADWEEP,2010,Tempo/Vans (Private),0,0,0
LAKSHADWEEP,2010,Jeep (Government),0,0,0
LAKSHADWEEP,2010,Jeep (Private),0,0,0
LAKSHADWEEP,2010,Car (Government),0,0,0
LAKSHADWEEP,2010,Car (Private),0,0,0
LAKSHADWEEP,2010,Three Wheeler,0,0,0
LAKSHADWEEP,2010,Two Wheeler,0,0,0
LAKSHADWEEP,2010,Bicycle,0,0,0
LAKSHADWEEP,2010,Pedestrian,0,0,0
LAKSHADWEEP,2010,Others (Please Specify),0,0,0
LAKSHADWEEP,2010,Total Deaths (Persons),0,0,0
LAKSHADWEEP,2010,Total Truck/Lorry,0,0,0
LAKSHADWEEP,2010,Total Bus,0,0,0
LAKSHADWEEP,2010,Total Tempo/Vans,0,0,0
LAKSHADWEEP,2010,Total Jeep,0,0,0
LAKSHADWEEP,2010,Total Car,0,0,0
LAKSHADWEEP,2011,Truck/Lorry (Government),0,0,0
LAKSHADWEEP,2011,Truck/Lorry (Private),0,0,0
LAKSHADWEEP,2011,Bus (Government),0,0,0
LAKSHADWEEP,2011,Bus (Private),0,0,0
LAKSHADWEEP,2011,Tempo/Vans (Government),0,0,0
LAKSHADWEEP,2011,Tempo/Vans (Private),0,0,0
LAKSHADWEEP,2011,Jeep (Government),0,0,0
LAKSHADWEEP,2011,Jeep (Private),0,0,0
LAKSHADWEEP,2011,Car (Government),0,0,0
LAKSHADWEEP,2011,Car (Private),0,0,0
LAKSHADWEEP,2011,Three Wheeler,0,0,0
LAKSHADWEEP,2011,Two Wheeler,0,0,0
LAKSHADWEEP,2011,Bicycle,0,0,0
LAKSHADWEEP,2011,Pedestrian,0,0,0
LAKSHADWEEP,2011,Others (Please Specify),0,0,0
LAKSHADWEEP,2011,Total Deaths (Persons),0,0,0
LAKSHADWEEP,2011,Total Truck/Lorry,0,0,0
LAKSHADWEEP,2011,Total Bus,0,0,0
LAKSHADWEEP,2011,Total Tempo/Vans,0,0,0
LAKSHADWEEP,2011,Total Jeep,0,0,0
LAKSHADWEEP,2011,Total Car,0,0,0
LAKSHADWEEP,2012,Truck/Lorry (Government),0,0,0
LAKSHADWEEP,2012,Truck/Lorry (Private),0,0,0
LAKSHADWEEP,2012,Bus (Government),0,0,0
LAKSHADWEEP,2012,Bus (Private),0,0,0
LAKSHADWEEP,2012,Tempo/Vans (Government),0,0,0
LAKSHADWEEP,2012,Tempo/Vans (Private),0,0,0
LAKSHADWEEP,2012,Jeep (Government),0,0,0
LAKSHADWEEP,2012,Jeep (Private),0,0,0
LAKSHADWEEP,2012,Car (Government),0,0,0
LAKSHADWEEP,2012,Car (Private),0,0,0
LAKSHADWEEP,2012,Three Wheeler,0,0,0
LAKSHADWEEP,2012,Two Wheeler,0,0,0
LAKSHADWEEP,2012,Bicycle,0,0,0
LAKSHADWEEP,2012,Pedestrian,0,0,0
LAKSHADWEEP,2012,Others (Please Specify),0,0,0
LAKSHADWEEP,2012,Total Deaths (Persons),0,0,0
LAKSHADWEEP,2012,Total Truck/Lorry,0,0,0
LAKSHADWEEP,2012,Total Bus,0,0,0
LAKSHADWEEP,2012,Total Tempo/Vans,0,0,0
LAKSHADWEEP,2012,Total Jeep,0,0,0
LAKSHADWEEP,2012,Total Car,0,0,0
PUDUCHERRY,2001,Truck/Lorry (Government),0,0,0
PUDUCHERRY,2001,Truck/Lorry (Private),6,0,6
PUDUCHERRY,2001,Bus (Government),0,0,0
PUDUCHERRY,2001,Bus (Private),7,1,8
PUDUCHERRY,2001,Tempo/Vans (Government),0,0,0
PUDUCHERRY,2001,Tempo/Vans (Private),0,0,0
PUDUCHERRY,2001,Jeep (Government),0,0,0
PUDUCHERRY,2001,Jeep (Private),0,0,0
PUDUCHERRY,2001,Car (Government),0,0,0
PUDUCHERRY,2001,Car (Private),2,0,2
PUDUCHERRY,2001,Three Wheeler,3,0,3
PUDUCHERRY,2001,Two Wheeler,37,10,47
PUDUCHERRY,2001,Bicycle,39,3,42
PUDUCHERRY,2001,Pedestrian,44,16,60
PUDUCHERRY,2001,Others (Please Specify),1,1,2
PUDUCHERRY,2001,Total Deaths (Persons),139,31,170
PUDUCHERRY,2001,Total Truck/Lorry,6,0,6
PUDUCHERRY,2001,Total Bus,7,1,8
PUDUCHERRY,2001,Total Tempo/Vans,0,0,0
PUDUCHERRY,2001,Total Jeep,0,0,0
PUDUCHERRY,2001,Total Car,2,0,2
PUDUCHERRY,2002,Truck/Lorry (Government),2,0,2
PUDUCHERRY,2002,Truck/Lorry (Private),0,0,0
PUDUCHERRY,2002,Bus (Government),2,0,2
PUDUCHERRY,2002,Bus (Private),7,2,9
PUDUCHERRY,2002,Tempo/Vans (Government),0,0,0
PUDUCHERRY,2002,Tempo/Vans (Private),1,0,1
PUDUCHERRY,2002,Jeep (Government),0,0,0
PUDUCHERRY,2002,Jeep (Private),1,0,1
PUDUCHERRY,2002,Car (Government),0,0,0
PUDUCHERRY,2002,Car (Private),1,1,2
PUDUCHERRY,2002,Three Wheeler,1,2,3
PUDUCHERRY,2002,Two Wheeler,51,5,56
PUDUCHERRY,2002,Bicycle,38,5,43
PUDUCHERRY,2002,Pedestrian,59,11,70
PUDUCHERRY,2002,Others (Please Specify),2,1,3
PUDUCHERRY,2002,Total Deaths (Persons),165,27,192
PUDUCHERRY,2002,Total Truck/Lorry,2,0,2
PUDUCHERRY,2002,Total Bus,9,2,11
PUDUCHERRY,2002,Total Tempo/Vans,1,0,1
PUDUCHERRY,2002,Total Jeep,1,0,1
PUDUCHERRY,2002,Total Car,1,1,2
PUDUCHERRY,2003,Truck/Lorry (Government),0,0,0
PUDUCHERRY,2003,Truck/Lorry (Private),8,0,8
PUDUCHERRY,2003,Bus (Government),1,0,1
PUDUCHERRY,2003,Bus (Private),2,0,2
PUDUCHERRY,2003,Tempo/Vans (Government),0,0,0
PUDUCHERRY,2003,Tempo/Vans (Private),1,0,1
PUDUCHERRY,2003,Jeep (Government),0,0,0
PUDUCHERRY,2003,Jeep (Private),0,0,0
PUDUCHERRY,2003,Car (Government),0,0,0
PUDUCHERRY,2003,Car (Private),1,0,1
PUDUCHERRY,2003,Three Wheeler,1,1,2
PUDUCHERRY,2003,Two Wheeler,64,8,72
PUDUCHERRY,2003,Bicycle,25,4,29
PUDUCHERRY,2003,Pedestrian,57,12,69
PUDUCHERRY,2003,Others (Please Specify),3,0,3
PUDUCHERRY,2003,Total Deaths (Persons),163,25,188
PUDUCHERRY,2003,Total Truck/Lorry,8,0,8
PUDUCHERRY,2003,Total Bus,3,0,3
PUDUCHERRY,2003,Total Tempo/Vans,1,0,1
PUDUCHERRY,2003,Total Jeep,0,0,0
PUDUCHERRY,2003,Total Car,1,0,1
PUDUCHERRY,2004,Truck/Lorry (Government),2,0,2
PUDUCHERRY,2004,Truck/Lorry (Private),48,11,59
PUDUCHERRY,2004,Bus (Government),8,1,9
PUDUCHERRY,2004,Bus (Private),23,3,26
PUDUCHERRY,2004,Tempo/Vans (Government),1,0,1
PUDUCHERRY,2004,Tempo/Vans (Private),9,2,11
PUDUCHERRY,2004,Jeep (Government),0,0,0
PUDUCHERRY,2004,Jeep (Private),3,1,4
PUDUCHERRY,2004,Car (Government),0,0,0
PUDUCHERRY,2004,Car (Private),11,2,13
PUDUCHERRY,2004,Three Wheeler,6,1,7
PUDUCHERRY,2004,Two Wheeler,36,6,42
PUDUCHERRY,2004,Bicycle,0,0,0
PUDUCHERRY,2004,Pedestrian,0,0,0
PUDUCHERRY,2004,Others (Please Specify),6,0,6
PUDUCHERRY,2004,Total Deaths (Persons),153,27,180
PUDUCHERRY,2004,Total Truck/Lorry,50,11,61
PUDUCHERRY,2004,Total Bus,31,4,35
PUDUCHERRY,2004,Total Tempo/Vans,10,2,12
PUDUCHERRY,2004,Total Jeep,3,1,4
PUDUCHERRY,2004,Total Car,11,2,13
PUDUCHERRY,2005,Truck/Lorry (Government),0,0,0
PUDUCHERRY,2005,Truck/Lorry (Private),52,7,59
PUDUCHERRY,2005,Bus (Government),13,1,14
PUDUCHERRY,2005,Bus (Private),22,6,28
PUDUCHERRY,2005,Tempo/Vans (Government),2,0,2
PUDUCHERRY,2005,Tempo/Vans (Private),9,1,10
PUDUCHERRY,2005,Jeep (Government),1,0,1
PUDUCHERRY,2005,Jeep (Private),1,0,1
PUDUCHERRY,2005,Car (Government),0,0,0
PUDUCHERRY,2005,Car (Private),14,4,18
PUDUCHERRY,2005,Three Wheeler,11,4,15
PUDUCHERRY,2005,Two Wheeler,50,15,65
PUDUCHERRY,2005,Bicycle,0,0,0
PUDUCHERRY,2005,Pedestrian,0,0,0
PUDUCHERRY,2005,Others (Please Specify),13,0,13
PUDUCHERRY,2005,Total Deaths (Persons),188,38,226
PUDUCHERRY,2005,Total Truck/Lorry,52,7,59
PUDUCHERRY,2005,Total Bus,35,7,42
PUDUCHERRY,2005,Total Tempo/Vans,11,1,12
PUDUCHERRY,2005,Total Jeep,2,0,2
PUDUCHERRY,2005,Total Car,14,4,18
PUDUCHERRY,2006,Truck/Lorry (Government),0,0,0
PUDUCHERRY,2006,Truck/Lorry (Private),44,10,54
PUDUCHERRY,2006,Bus (Government),14,1,15
PUDUCHERRY,2006,Bus (Private),28,5,33
PUDUCHERRY,2006,Tempo/Vans (Government),0,0,0
PUDUCHERRY,2006,Tempo/Vans (Private),9,0,9
PUDUCHERRY,2006,Jeep (Government),0,0,0
PUDUCHERRY,2006,Jeep (Private),1,0,1
PUDUCHERRY,2006,Car (Government),0,0,0
PUDUCHERRY,2006,Car (Private),16,1,17
PUDUCHERRY,2006,Three Wheeler,16,2,18
PUDUCHERRY,2006,Two Wheeler,52,8,60
PUDUCHERRY,2006,Bicycle,0,0,0
PUDUCHERRY,2006,Pedestrian,0,0,0
PUDUCHERRY,2006,Others (Please Specify),9,1,10
PUDUCHERRY,2006,Total Deaths (Persons),189,28,217
PUDUCHERRY,2006,Total Truck/Lorry,44,10,54
PUDUCHERRY,2006,Total Bus,42,6,48
PUDUCHERRY,2006,Total Tempo/Vans,9,0,9
PUDUCHERRY,2006,Total Jeep,1,0,1
PUDUCHERRY,2006,Total Car,16,1,17
PUDUCHERRY,2007,Truck/Lorry (Government),0,0,0
PUDUCHERRY,2007,Truck/Lorry (Private),8,0,8
PUDUCHERRY,2007,Bus (Government),0,0,0
PUDUCHERRY,2007,Bus (Private),15,0,15
PUDUCHERRY,2007,Tempo/Vans (Government),0,0,0
PUDUCHERRY,2007,Tempo/Vans (Private),2,0,2
PUDUCHERRY,2007,Jeep (Government),0,0,0
PUDUCHERRY,2007,Jeep (Private),0,0,0
PUDUCHERRY,2007,Car (Government),0,0,0
PUDUCHERRY,2007,Car (Private),3,4,7
PUDUCHERRY,2007,Three Wheeler,2,0,2
PUDUCHERRY,2007,Two Wheeler,72,8,80
PUDUCHERRY,2007,Bicycle,28,4,32
PUDUCHERRY,2007,Pedestrian,87,21,108
PUDUCHERRY,2007,Others (Please Specify),1,0,1
PUDUCHERRY,2007,Total Deaths (Persons),218,37,255
PUDUCHERRY,2007,Total Truck/Lorry,8,0,8
PUDUCHERRY,2007,Total Bus,15,0,15
PUDUCHERRY,2007,Total Tempo/Vans,2,0,2
PUDUCHERRY,2007,Total Jeep,0,0,0
PUDUCHERRY,2007,Total Car,3,4,7
PUDUCHERRY,2008,Truck/Lorry (Government),0,0,0
PUDUCHERRY,2008,Truck/Lorry (Private),44,2,46
PUDUCHERRY,2008,Bus (Government),11,2,13
PUDUCHERRY,2008,Bus (Private),22,4,26
PUDUCHERRY,2008,Tempo/Vans (Government),0,0,0
PUDUCHERRY,2008,Tempo/Vans (Private),21,3,24
PUDUCHERRY,2008,Jeep (Government),1,0,1
PUDUCHERRY,2008,Jeep (Private),0,0,0
PUDUCHERRY,2008,Car (Government),0,0,0
PUDUCHERRY,2008,Car (Private),18,2,20
PUDUCHERRY,2008,Three Wheeler,1,1,2
PUDUCHERRY,2008,Two Wheeler,60,11,71
PUDUCHERRY,2008,Bicycle,0,0,0
PUDUCHERRY,2008,Pedestrian,0,0,0
PUDUCHERRY,2008,Others (Please Specify),6,3,9
PUDUCHERRY,2008,Total Deaths (Persons),184,28,212
PUDUCHERRY,2008,Total Truck/Lorry,44,2,46
PUDUCHERRY,2008,Total Bus,33,6,39
PUDUCHERRY,2008,Total Tempo/Vans,21,3,24
PUDUCHERRY,2008,Total Jeep,1,0,1
PUDUCHERRY,2008,Total Car,18,2,20
PUDUCHERRY,2009,Truck/Lorry (Government),0,0,0
PUDUCHERRY,2009,Truck/Lorry (Private),29,4,33
PUDUCHERRY,2009,Bus (Government),9,1,10
PUDUCHERRY,2009,Bus (Private),32,4,36
PUDUCHERRY,2009,Tempo/Vans (Government),0,0,0
PUDUCHERRY,2009,Tempo/Vans (Private),22,1,23
PUDUCHERRY,2009,Jeep (Government),0,0,0
PUDUCHERRY,2009,Jeep (Private),0,0,0
PUDUCHERRY,2009,Car (Government),0,0,0
PUDUCHERRY,2009,Car (Private),19,1,20
PUDUCHERRY,2009,Three Wheeler,3,0,3
PUDUCHERRY,2009,Two Wheeler,58,12,70
PUDUCHERRY,2009,Bicycle,1,0,1
PUDUCHERRY,2009,Pedestrian,0,0,0
PUDUCHERRY,2009,Others (Please Specify),21,1,22
PUDUCHERRY,2009,Total Deaths (Persons),194,24,218
PUDUCHERRY,2009,Total Truck/Lorry,29,4,33
PUDUCHERRY,2009,Total Bus,41,5,46
PUDUCHERRY,2009,Total Tempo/Vans,22,1,23
PUDUCHERRY,2009,Total Jeep,0,0,0
PUDUCHERRY,2009,Total Car,19,1,20
PUDUCHERRY,2010,Truck/Lorry (Government),0,0,0
PUDUCHERRY,2010,Truck/Lorry (Private),37,3,40
PUDUCHERRY,2010,Bus (Government),12,2,14
PUDUCHERRY,2010,Bus (Private),24,6,30
PUDUCHERRY,2010,Tempo/Vans (Government),0,0,0
PUDUCHERRY,2010,Tempo/Vans (Private),23,7,30
PUDUCHERRY,2010,Jeep (Government),0,0,0
PUDUCHERRY,2010,Jeep (Private),1,0,1
PUDUCHERRY,2010,Car (Government),0,0,0
PUDUCHERRY,2010,Car (Private),31,3,34
PUDUCHERRY,2010,Three Wheeler,5,1,6
PUDUCHERRY,2010,Two Wheeler,54,9,63
PUDUCHERRY,2010,Bicycle,0,0,0
PUDUCHERRY,2010,Pedestrian,0,0,0
PUDUCHERRY,2010,Others (Please Specify),18,3,21
PUDUCHERRY,2010,Total Deaths (Persons),205,34,239
PUDUCHERRY,2010,Total Truck/Lorry,37,3,40
PUDUCHERRY,2010,Total Bus,36,8,44
PUDUCHERRY,2010,Total Tempo/Vans,23,7,30
PUDUCHERRY,2010,Total Jeep,1,0,1
PUDUCHERRY,2010,Total Car,31,3,34
PUDUCHERRY,2011,Truck/Lorry (Government),0,0,0
PUDUCHERRY,2011,Truck/Lorry (Private),45,5,50
PUDUCHERRY,2011,Bus (Government),5,2,7
PUDUCHERRY,2011,Bus (Private),24,7,31
PUDUCHERRY,2011,Tempo/Vans (Government),1,0,1
PUDUCHERRY,2011,Tempo/Vans (Private),18,1,19
PUDUCHERRY,2011,Jeep (Government),0,0,0
PUDUCHERRY,2011,Jeep (Private),0,0,0
PUDUCHERRY,2011,Car (Government),0,0,0
PUDUCHERRY,2011,Car (Private),21,3,24
PUDUCHERRY,2011,Three Wheeler,2,0,2
PUDUCHERRY,2011,Two Wheeler,54,20,74
PUDUCHERRY,2011,Bicycle,0,0,0
PUDUCHERRY,2011,Pedestrian,0,0,0
PUDUCHERRY,2011,Others (Please Specify),23,2,25
PUDUCHERRY,2011,Total Deaths (Persons),193,40,233
PUDUCHERRY,2011,Total Truck/Lorry,45,5,50
PUDUCHERRY,2011,Total Bus,29,9,38
PUDUCHERRY,2011,Total Tempo/Vans,19,1,20
PUDUCHERRY,2011,Total Jeep,0,0,0
PUDUCHERRY,2011,Total Car,21,3,24
PUDUCHERRY,2012,Truck/Lorry (Government),0,0,0
PUDUCHERRY,2012,Truck/Lorry (Private),41,3,44
PUDUCHERRY,2012,Bus (Government),11,1,12
PUDUCHERRY,2012,Bus (Private),26,4,30
PUDUCHERRY,2012,Tempo/Vans (Government),0,0,0
PUDUCHERRY,2012,Tempo/Vans (Private),24,4,28
PUDUCHERRY,2012,Jeep (Government),0,0,0
PUDUCHERRY,2012,Jeep (Private),0,0,0
PUDUCHERRY,2012,Car (Government),0,0,0
PUDUCHERRY,2012,Car (Private),22,2,24
PUDUCHERRY,2012,Three Wheeler,0,0,0
PUDUCHERRY,2012,Two Wheeler,49,15,64
PUDUCHERRY,2012,Bicycle,0,0,0
PUDUCHERRY,2012,Pedestrian,0,0,0
PUDUCHERRY,2012,Others (Please Specify),22,9,31
PUDUCHERRY,2012,Total Deaths (Persons),195,38,233
PUDUCHERRY,2012,Total Truck/Lorry,41,3,44
PUDUCHERRY,2012,Total Bus,37,5,42
PUDUCHERRY,2012,Total Tempo/Vans,24,4,28
PUDUCHERRY,2012,Total Jeep,0,0,0
PUDUCHERRY,2012,Total Car,22,2,24
TOTAL (UTs),2001,Truck/Lorry (Government),15,2,17
TOTAL (UTs),2001,Truck/Lorry (Private),137,19,156
TOTAL (UTs),2001,Bus (Government),36,10,46
TOTAL (UTs),2001,Bus (Private),162,33,195
TOTAL (UTs),2001,Tempo/Vans (Government),5,1,6
TOTAL (UTs),2001,Tempo/Vans (Private),94,17,111
TOTAL (UTs),2001,Jeep (Government),1,0,1
TOTAL (UTs),2001,Jeep (Private),12,1,13
TOTAL (UTs),2001,Car (Government),2,0,2
TOTAL (UTs),2001,Car (Private),109,16,125
TOTAL (UTs),2001,Three Wheeler,64,9,73
TOTAL (UTs),2001,Two Wheeler,398,64,462
TOTAL (UTs),2001,Bicycle,212,12,224
TOTAL (UTs),2001,Pedestrian,557,94,651
TOTAL (UTs),2001,Others (Please Specify),147,22,169
TOTAL (UTs),2001,Total Deaths (Persons),1951,300,2251
TOTAL (UTs),2001,Total Truck/Lorry,152,21,173
TOTAL (UTs),2001,Total Bus,198,43,241
TOTAL (UTs),2001,Total Tempo/Vans,99,18,117
TOTAL (UTs),2001,Total Jeep,13,1,14
TOTAL (UTs),2001,Total Car,111,16,127
TOTAL (UTs),2002,Truck/Lorry (Government),10,0,10
TOTAL (UTs),2002,Truck/Lorry (Private),97,7,104
TOTAL (UTs),2002,Bus (Government),19,4,23
TOTAL (UTs),2002,Bus (Private),108,24,132
TOTAL (UTs),2002,Tempo/Vans (Government),2,0,2
TOTAL (UTs),2002,Tempo/Vans (Private),75,18,93
TOTAL (UTs),2002,Jeep (Government),2,1,3
TOTAL (UTs),2002,Jeep (Private),21,2,23
TOTAL (UTs),2002,Car (Government),2,1,3
TOTAL (UTs),2002,Car (Private),99,22,121
TOTAL (UTs),2002,Three Wheeler,76,10,86
TOTAL (UTs),2002,Two Wheeler,460,45,505
TOTAL (UTs),2002,Bicycle,206,12,218
TOTAL (UTs),2002,Pedestrian,628,92,720
TOTAL (UTs),2002,Others (Please Specify),89,7,96
TOTAL (UTs),2002,Total Deaths (Persons),1894,245,2139
TOTAL (UTs),2002,Total Truck/Lorry,107,7,114
TOTAL (UTs),2002,Total Bus,127,28,155
TOTAL (UTs),2002,Total Tempo/Vans,77,18,95
TOTAL (UTs),2002,Total Jeep,23,3,26
TOTAL (UTs),2002,Total Car,101,23,124
TOTAL (UTs),2003,Truck/Lorry (Government),17,2,19
TOTAL (UTs),2003,Truck/Lorry (Private),119,14,133
TOTAL (UTs),2003,Bus (Government),23,3,26
TOTAL (UTs),2003,Bus (Private),147,22,169
TOTAL (UTs),2003,Tempo/Vans (Government),3,0,3
TOTAL (UTs),2003,Tempo/Vans (Private),96,17,113
TOTAL (UTs),2003,Jeep (Government),2,0,2
TOTAL (UTs),2003,Jeep (Private),22,0,22
TOTAL (UTs),2003,Car (Government),1,0,1
TOTAL (UTs),2003,Car (Private),89,24,113
TOTAL (UTs),2003,Three Wheeler,58,4,62
TOTAL (UTs),2003,Two Wheeler,493,54,547
TOTAL (UTs),2003,Bicycle,210,18,228
TOTAL (UTs),2003,Pedestrian,521,81,602
TOTAL (UTs),2003,Others (Please Specify),238,26,264
TOTAL (UTs),2003,Total Deaths (Persons),2039,265,2304
TOTAL (UTs),2003,Total Truck/Lorry,136,16,152
TOTAL (UTs),2003,Total Bus,170,25,195
TOTAL (UTs),2003,Total Tempo/Vans,99,17,116
TOTAL (UTs),2003,Total Jeep,24,0,24
TOTAL (UTs),2003,Total Car,90,24,114
TOTAL (UTs),2004,Truck/Lorry (Government),6,1,7
TOTAL (UTs),2004,Truck/Lorry (Private),185,26,211
TOTAL (UTs),2004,Bus (Government),34,4,38
TOTAL (UTs),2004,Bus (Private),146,33,179
TOTAL (UTs),2004,Tempo/Vans (Government),2,0,2
TOTAL (UTs),2004,Tempo/Vans (Private),103,3,106
TOTAL (UTs),2004,Jeep (Government),2,0,2
TOTAL (UTs),2004,Jeep (Private),23,4,27
TOTAL (UTs),2004,Car (Government),10,1,11
TOTAL (UTs),2004,Car (Private),122,15,137
TOTAL (UTs),2004,Three Wheeler,100,12,112
TOTAL (UTs),2004,Two Wheeler,463,56,519
TOTAL (UTs),2004,Bicycle,139,4,143
TOTAL (UTs),2004,Pedestrian,584,98,682
TOTAL (UTs),2004,Others (Please Specify),180,25,205
TOTAL (UTs),2004,Total Deaths (Persons),2099,282,2381
TOTAL (UTs),2004,Total Truck/Lorry,191,27,218
TOTAL (UTs),2004,Total Bus,180,37,217
TOTAL (UTs),2004,Total Tempo/Vans,105,3,108
TOTAL (UTs),2004,Total Jeep,25,4,29
TOTAL (UTs),2004,Total Car,132,16,148
TOTAL (UTs),2005,Truck/Lorry (Government),2,3,5
TOTAL (UTs),2005,Truck/Lorry (Private),207,19,226
TOTAL (UTs),2005,Bus (Government),57,11,68
TOTAL (UTs),2005,Bus (Private),136,31,167
TOTAL (UTs),2005,Tempo/Vans (Government),9,1,10
TOTAL (UTs),2005,Tempo/Vans (Private),91,10,101
TOTAL (UTs),2005,Jeep (Government),2,0,2
TOTAL (UTs),2005,Jeep (Private),18,5,23
TOTAL (UTs),2005,Car (Government),0,0,0
TOTAL (UTs),2005,Car (Private),133,23,156
TOTAL (UTs),2005,Three Wheeler,87,17,104
TOTAL (UTs),2005,Two Wheeler,558,61,619
TOTAL (UTs),2005,Bicycle,136,7,143
TOTAL (UTs),2005,Pedestrian,437,90,527
TOTAL (UTs),2005,Others (Please Specify),316,18,334
TOTAL (UTs),2005,Total Deaths (Persons),2189,296,2485
TOTAL (UTs),2005,Total Truck/Lorry,209,22,231
TOTAL (UTs),2005,Total Bus,193,42,235
TOTAL (UTs),2005,Total Tempo/Vans,100,11,111
TOTAL (UTs),2005,Total Jeep,20,5,25
TOTAL (UTs),2005,Total Car,133,23,156
TOTAL (UTs),2006,Truck/Lorry (Government),7,1,8
TOTAL (UTs),2006,Truck/Lorry (Private),194,20,214
TOTAL (UTs),2006,Bus (Government),52,2,54
TOTAL (UTs),2006,Bus (Private),150,20,170
TOTAL (UTs),2006,Tempo/Vans (Government),0,0,0
TOTAL (UTs),2006,Tempo/Vans (Private),106,13,119
TOTAL (UTs),2006,Jeep (Government),2,0,2
TOTAL (UTs),2006,Jeep (Private),21,3,24
TOTAL (UTs),2006,Car (Government),0,0,0
TOTAL (UTs),2006,Car (Private),149,26,175
TOTAL (UTs),2006,Three Wheeler,97,12,109
TOTAL (UTs),2006,Two Wheeler,610,54,664
TOTAL (UTs),2006,Bicycle,123,2,125
TOTAL (UTs),2006,Pedestrian,654,83,737
TOTAL (UTs),2006,Others (Please Specify),202,17,219
TOTAL (UTs),2006,Total Deaths (Persons),2367,253,2620
TOTAL (UTs),2006,Total Truck/Lorry,201,21,222
TOTAL (UTs),2006,Total Bus,202,22,224
TOTAL (UTs),2006,Total Tempo/Vans,106,13,119
TOTAL (UTs),2006,Total Jeep,23,3,26
TOTAL (UTs),2006,Total Car,149,26,175
TOTAL (UTs),2007,Truck/Lorry (Government),2,1,3
TOTAL (UTs),2007,Truck/Lorry (Private),145,9,154
TOTAL (UTs),2007,Bus (Government),33,5,38
TOTAL (UTs),2007,Bus (Private),136,16,152
TOTAL (UTs),2007,Tempo/Vans (Government),3,1,4
TOTAL (UTs),2007,Tempo/Vans (Private),99,7,106
TOTAL (UTs),2007,Jeep (Government),3,1,4
TOTAL (UTs),2007,Jeep (Private),16,2,18
TOTAL (UTs),2007,Car (Government),4,1,5
TOTAL (UTs),2007,Car (Private),153,38,191
TOTAL (UTs),2007,Three Wheeler,72,13,85
TOTAL (UTs),2007,Two Wheeler,664,58,722
TOTAL (UTs),2007,Bicycle,156,9,165
TOTAL (UTs),2007,Pedestrian,636,93,729
TOTAL (UTs),2007,Others (Please Specify),256,14,270
TOTAL (UTs),2007,Total Deaths (Persons),2378,268,2646
TOTAL (UTs),2007,Total Truck/Lorry,147,10,157
TOTAL (UTs),2007,Total Bus,169,21,190
TOTAL (UTs),2007,Total Tempo/Vans,102,8,110
TOTAL (UTs),2007,Total Jeep,19,3,22
TOTAL (UTs),2007,Total Car,157,39,196
TOTAL (UTs),2008,Truck/Lorry (Government),4,1,5
TOTAL (UTs),2008,Truck/Lorry (Private),214,17,231
TOTAL (UTs),2008,Bus (Government),27,9,36
TOTAL (UTs),2008,Bus (Private),122,21,143
TOTAL (UTs),2008,Tempo/Vans (Government),1,1,2
TOTAL (UTs),2008,Tempo/Vans (Private),135,10,145
TOTAL (UTs),2008,Jeep (Government),1,0,1
TOTAL (UTs),2008,Jeep (Private),9,4,13
TOTAL (UTs),2008,Car (Government),1,2,3
TOTAL (UTs),2008,Car (Private),152,26,178
TOTAL (UTs),2008,Three Wheeler,85,6,91
TOTAL (UTs),2008,Two Wheeler,659,67,726
TOTAL (UTs),2008,Bicycle,95,3,98
TOTAL (UTs),2008,Pedestrian,555,84,639
TOTAL (UTs),2008,Others (Please Specify),230,23,253
TOTAL (UTs),2008,Total Deaths (Persons),2290,274,2564
TOTAL (UTs),2008,Total Truck/Lorry,218,18,236
TOTAL (UTs),2008,Total Bus,149,30,179
TOTAL (UTs),2008,Total Tempo/Vans,136,11,147
TOTAL (UTs),2008,Total Jeep,10,4,14
TOTAL (UTs),2008,Total Car,153,28,181
TOTAL (UTs),2009,Truck/Lorry (Government),9,1,10
TOTAL (UTs),2009,Truck/Lorry (Private),141,17,158
TOTAL (UTs),2009,Bus (Government),31,7,38
TOTAL (UTs),2009,Bus (Private),86,14,100
TOTAL (UTs),2009,Tempo/Vans (Government),2,0,2
TOTAL (UTs),2009,Tempo/Vans (Private),84,11,95
TOTAL (UTs),2009,Jeep (Government),0,0,0
TOTAL (UTs),2009,Jeep (Private),16,1,17
TOTAL (UTs),2009,Car (Government),2,1,3
TOTAL (UTs),2009,Car (Private),154,19,173
TOTAL (UTs),2009,Three Wheeler,65,7,72
TOTAL (UTs),2009,Two Wheeler,822,76,898
TOTAL (UTs),2009,Bicycle,171,6,177
TOTAL (UTs),2009,Pedestrian,498,71,569
TOTAL (UTs),2009,Others (Please Specify),185,12,197
TOTAL (UTs),2009,Total Deaths (Persons),2266,243,2509
TOTAL (UTs),2009,Total Truck/Lorry,150,18,168
TOTAL (UTs),2009,Total Bus,117,21,138
TOTAL (UTs),2009,Total Tempo/Vans,86,11,97
TOTAL (UTs),2009,Total Jeep,16,1,17
TOTAL (UTs),2009,Total Car,156,20,176
TOTAL (UTs),2010,Truck/Lorry (Government),4,1,5
TOTAL (UTs),2010,Truck/Lorry (Private),173,17,190
TOTAL (UTs),2010,Bus (Government),32,7,39
TOTAL (UTs),2010,Bus (Private),91,14,105
TOTAL (UTs),2010,Tempo/Vans (Government),3,0,3
TOTAL (UTs),2010,Tempo/Vans (Private),108,15,123
TOTAL (UTs),2010,Jeep (Government),2,0,2
TOTAL (UTs),2010,Jeep (Private),20,1,21
TOTAL (UTs),2010,Car (Government),1,3,4
TOTAL (UTs),2010,Car (Private),235,25,260
TOTAL (UTs),2010,Three Wheeler,91,14,105
TOTAL (UTs),2010,Two Wheeler,754,77,831
TOTAL (UTs),2010,Bicycle,124,12,136
TOTAL (UTs),2010,Pedestrian,535,68,603
TOTAL (UTs),2010,Others (Please Specify),207,25,232
TOTAL (UTs),2010,Total Deaths (Persons),2380,279,2659
TOTAL (UTs),2010,Total Truck/Lorry,177,18,195
TOTAL (UTs),2010,Total Bus,123,21,144
TOTAL (UTs),2010,Total Tempo/Vans,111,15,126
TOTAL (UTs),2010,Total Jeep,22,1,23
TOTAL (UTs),2010,Total Car,236,28,264
TOTAL (UTs),2011,Truck/Lorry (Government),9,2,11
TOTAL (UTs),2011,Truck/Lorry (Private),167,18,185
TOTAL (UTs),2011,Bus (Government),42,13,55
TOTAL (UTs),2011,Bus (Private),64,14,78
TOTAL (UTs),2011,Tempo/Vans (Government),5,0,5
TOTAL (UTs),2011,Tempo/Vans (Private),98,8,106
TOTAL (UTs),2011,Jeep (Government),1,0,1
TOTAL (UTs),2011,Jeep (Private),20,2,22
TOTAL (UTs),2011,Car (Government),2,0,2
TOTAL (UTs),2011,Car (Private),193,29,222
TOTAL (UTs),2011,Three Wheeler,66,7,73
TOTAL (UTs),2011,Two Wheeler,711,91,802
TOTAL (UTs),2011,Bicycle,98,3,101
TOTAL (UTs),2011,Pedestrian,575,102,677
TOTAL (UTs),2011,Others (Please Specify),224,13,237
TOTAL (UTs),2011,Total Deaths (Persons),2275,302,2577
TOTAL (UTs),2011,Total Truck/Lorry,176,20,196
TOTAL (UTs),2011,Total Bus,106,27,133
TOTAL (UTs),2011,Total Tempo/Vans,103,8,111
TOTAL (UTs),2011,Total Jeep,21,2,23
TOTAL (UTs),2011,Total Car,195,29,224
TOTAL (UTs),2012,Truck/Lorry (Government),2,0,2
TOTAL (UTs),2012,Truck/Lorry (Private),163,22,185
TOTAL (UTs),2012,Bus (Government),36,8,44
TOTAL (UTs),2012,Bus (Private),56,11,67
TOTAL (UTs),2012,Tempo/Vans (Government),1,1,2
TOTAL (UTs),2012,Tempo/Vans (Private),119,15,134
TOTAL (UTs),2012,Jeep (Government),1,0,1
TOTAL (UTs),2012,Jeep (Private),13,0,13
TOTAL (UTs),2012,Car (Government),4,1,5
TOTAL (UTs),2012,Car (Private),220,18,238
TOTAL (UTs),2012,Three Wheeler,62,12,74
TOTAL (UTs),2012,Two Wheeler,581,59,640
TOTAL (UTs),2012,Bicycle,100,1,101
TOTAL (UTs),2012,Pedestrian,487,62,549
TOTAL (UTs),2012,Others (Please Specify),236,29,265
TOTAL (UTs),2012,Total Deaths (Persons),2081,239,2320
TOTAL (UTs),2012,Total Truck/Lorry,165,22,187
TOTAL (UTs),2012,Total Bus,92,19,111
TOTAL (UTs),2012,Total Tempo/Vans,120,16,136
TOTAL (UTs),2012,Total Jeep,14,0,14
TOTAL (UTs),2012,Total Car,224,19,243
TOTAL (ALL INDIA),2001,Truck/Lorry (Government),516,116,632
TOTAL (ALL INDIA),2001,Truck/Lorry (Private),17619,2719,20338
TOTAL (ALL INDIA),2001,Bus (Government),3856,863,4719
TOTAL (ALL INDIA),2001,Bus (Private),5649,1549,7198
TOTAL (ALL INDIA),2001,Tempo/Vans (Government),162,37,199
TOTAL (ALL INDIA),2001,Tempo/Vans (Private),4350,1005,5355
TOTAL (ALL INDIA),2001,Jeep (Government),291,45,336
TOTAL (ALL INDIA),2001,Jeep (Private),6632,1446,8078
TOTAL (ALL INDIA),2001,Car (Government),182,37,219
TOTAL (ALL INDIA),2001,Car (Private),4064,1039,5103
TOTAL (ALL INDIA),2001,Three Wheeler,2433,598,3031
TOTAL (ALL INDIA),2001,Two Wheeler,8500,1138,9638
TOTAL (ALL INDIA),2001,Bicycle,2058,218,2276
TOTAL (ALL INDIA),2001,Pedestrian,5368,1437,6805
TOTAL (ALL INDIA),2001,Others (Please Specify),5196,1139,6335
TOTAL (ALL INDIA),2001,Total Deaths (Persons),66876,13386,80262
TOTAL (ALL INDIA),2001,Total Truck/Lorry,18135,2835,20970
TOTAL (ALL INDIA),2001,Total Bus,9505,2412,11917
TOTAL (ALL INDIA),2001,Total Tempo/Vans,4512,1042,5554
TOTAL (ALL INDIA),2001,Total Jeep,6923,1491,8414
TOTAL (ALL INDIA),2001,Total Car,4246,1076,5322
TOTAL (ALL INDIA),2002,Truck/Lorry (Government),611,166,777
TOTAL (ALL INDIA),2002,Truck/Lorry (Private),18134,2491,20625
TOTAL (ALL INDIA),2002,Bus (Government),3536,690,4226
TOTAL (ALL INDIA),2002,Bus (Private),5686,1482,7168
TOTAL (ALL INDIA),2002,Tempo/Vans (Government),188,32,220
TOTAL (ALL INDIA),2002,Tempo/Vans (Private),4585,952,5537
TOTAL (ALL INDIA),2002,Jeep (Government),248,40,288
TOTAL (ALL INDIA),2002,Jeep (Private),6346,1367,7713
TOTAL (ALL INDIA),2002,Car (Government),315,73,388
TOTAL (ALL INDIA),2002,Car (Private),4161,984,5145
TOTAL (ALL INDIA),2002,Three Wheeler,3117,637,3754
TOTAL (ALL INDIA),2002,Two Wheeler,9873,1345,11218
TOTAL (ALL INDIA),2002,Bicycle,2414,226,2640
TOTAL (ALL INDIA),2002,Pedestrian,6143,1365,7508
TOTAL (ALL INDIA),2002,Others (Please Specify),5593,1259,6852
TOTAL (ALL INDIA),2002,Total Deaths (Persons),70950,13109,84059
TOTAL (ALL INDIA),2002,Total Truck/Lorry,18745,2657,21402
TOTAL (ALL INDIA),2002,Total Bus,9222,2172,11394
TOTAL (ALL INDIA),2002,Total Tempo/Vans,4773,984,5757
TOTAL (ALL INDIA),2002,Total Jeep,6594,1407,8001
TOTAL (ALL INDIA),2002,Total Car,4476,1057,5533
TOTAL (ALL INDIA),2003,Truck/Lorry (Government),829,65,894
TOTAL (ALL INDIA),2003,Truck/Lorry (Private),17709,2596,20305
TOTAL (ALL INDIA),2003,Bus (Government),2772,713,3485
TOTAL (ALL INDIA),2003,Bus (Private),5930,1456,7386
TOTAL (ALL INDIA),2003,Tempo/Vans (Government),87,13,100
TOTAL (ALL INDIA),2003,Tempo/Vans (Private),4353,932,5285
TOTAL (ALL INDIA),2003,Jeep (Government),184,54,238
TOTAL (ALL INDIA),2003,Jeep (Private),6646,1472,8118
TOTAL (ALL INDIA),2003,Car (Government),81,12,93
TOTAL (ALL INDIA),2003,Car (Private),4580,1101,5681
TOTAL (ALL INDIA),2003,Three Wheeler,3017,698,3715
TOTAL (ALL INDIA),2003,Two Wheeler,11214,1595,12809
TOTAL (ALL INDIA),2003,Bicycle,2093,147,2240
TOTAL (ALL INDIA),2003,Pedestrian,6078,1329,7407
TOTAL (ALL INDIA),2003,Others (Please Specify),5555,1119,6674
TOTAL (ALL INDIA),2003,Total Deaths (Persons),71128,13302,84430
TOTAL (ALL INDIA),2003,Total Truck/Lorry,18538,2661,21199
TOTAL (ALL INDIA),2003,Total Bus,8702,2169,10871
TOTAL (ALL INDIA),2003,Total Tempo/Vans,4440,945,5385
TOTAL (ALL INDIA),2003,Total Jeep,6830,1526,8356
TOTAL (ALL INDIA),2003,Total Car,4661,1113,5774
TOTAL (ALL INDIA),2004,Truck/Lorry (Government),410,62,472
TOTAL (ALL INDIA),2004,Truck/Lorry (Private),18641,2659,21300
TOTAL (ALL INDIA),2004,Bus (Government),3374,752,4126
TOTAL (ALL INDIA),2004,Bus (Private),5300,1336,6636
TOTAL (ALL INDIA),2004,Tempo/Vans (Government),133,21,154
TOTAL (ALL INDIA),2004,Tempo/Vans (Private),4839,1033,5872
TOTAL (ALL INDIA),2004,Jeep (Government),169,29,198
TOTAL (ALL INDIA),2004,Jeep (Private),6864,1463,8327
TOTAL (ALL INDIA),2004,Car (Government),162,34,196
TOTAL (ALL INDIA),2004,Car (Private),5198,1132,6330
TOTAL (ALL INDIA),2004,Three Wheeler,3750,834,4584
TOTAL (ALL INDIA),2004,Two Wheeler,12814,1793,14607
TOTAL (ALL INDIA),2004,Bicycle,2352,203,2555
TOTAL (ALL INDIA),2004,Pedestrian,6593,1614,8207
TOTAL (ALL INDIA),2004,Others (Please Specify),6565,1247,7812
TOTAL (ALL INDIA),2004,Total Deaths (Persons),77164,14212,91376
TOTAL (ALL INDIA),2004,Total Truck/Lorry,19051,2721,21772
TOTAL (ALL INDIA),2004,Total Bus,8674,2088,10762
TOTAL (ALL INDIA),2004,Total Tempo/Vans,4972,1054,6026
TOTAL (ALL INDIA),2004,Total Jeep,7033,1492,8525
TOTAL (ALL INDIA),2004,Total Car,5360,1166,6526
TOTAL (ALL INDIA),2005,Truck/Lorry (Government),630,90,720
TOTAL (ALL INDIA),2005,Truck/Lorry (Private),18975,2889,21864
TOTAL (ALL INDIA),2005,Bus (Government),3385,709,4094
TOTAL (ALL INDIA),2005,Bus (Private),6576,1571,8147
TOTAL (ALL INDIA),2005,Tempo/Vans (Government),161,78,239
TOTAL (ALL INDIA),2005,Tempo/Vans (Private),5215,1011,6226
TOTAL (ALL INDIA),2005,Jeep (Government),292,43,335
TOTAL (ALL INDIA),2005,Jeep (Private),6875,1345,8220
TOTAL (ALL INDIA),2005,Car (Government),133,25,158
TOTAL (ALL INDIA),2005,Car (Private),6111,1271,7382
TOTAL (ALL INDIA),2005,Three Wheeler,3932,867,4799
TOTAL (ALL INDIA),2005,Two Wheeler,14016,2093,16109
TOTAL (ALL INDIA),2005,Bicycle,2735,188,2923
TOTAL (ALL INDIA),2005,Pedestrian,7121,1641,8762
TOTAL (ALL INDIA),2005,Others (Please Specify),7052,1224,8276
TOTAL (ALL INDIA),2005,Total Deaths (Persons),83209,15045,98254
TOTAL (ALL INDIA),2005,Total Truck/Lorry,19605,2979,22584
TOTAL (ALL INDIA),2005,Total Bus,9961,2280,12241
TOTAL (ALL INDIA),2005,Total Tempo/Vans,5376,1089,6465
TOTAL (ALL INDIA),2005,Total Jeep,7167,1388,8555
TOTAL (ALL INDIA),2005,Total Car,6244,1296,7540
TOTAL (ALL INDIA),2006,Truck/Lorry (Government),440,78,518
TOTAL (ALL INDIA),2006,Truck/Lorry (Private),20518,2832,23350
TOTAL (ALL INDIA),2006,Bus (Government),3556,800,4356
TOTAL (ALL INDIA),2006,Bus (Private),6614,1655,8269
TOTAL (ALL INDIA),2006,Tempo/Vans (Government),124,27,151
TOTAL (ALL INDIA),2006,Tempo/Vans (Private),4468,1020,5488
TOTAL (ALL INDIA),2006,Jeep (Government),209,56,265
TOTAL (ALL INDIA),2006,Jeep (Private),7271,1580,8851
TOTAL (ALL INDIA),2006,Car (Government),144,36,180
TOTAL (ALL INDIA),2006,Car (Private),7363,1991,9354
TOTAL (ALL INDIA),2006,Three Wheeler,4757,1128,5885
TOTAL (ALL INDIA),2006,Two Wheeler,16491,2342,18833
TOTAL (ALL INDIA),2006,Bicycle,2672,235,2907
TOTAL (ALL INDIA),2006,Pedestrian,7403,1503,8906
TOTAL (ALL INDIA),2006,Others (Please Specify),7147,1265,8412
TOTAL (ALL INDIA),2006,Total Deaths (Persons),89177,16548,105725
TOTAL (ALL INDIA),2006,Total Truck/Lorry,20958,2910,23868
TOTAL (ALL INDIA),2006,Total Bus,10170,2455,12625
TOTAL (ALL INDIA),2006,Total Tempo/Vans,4592,1047,5639
TOTAL (ALL INDIA),2006,Total Jeep,7480,1636,9116
TOTAL (ALL INDIA),2006,Total Car,7507,2027,9534
TOTAL (ALL INDIA),2007,Truck/Lorry (Government),552,106,658
TOTAL (ALL INDIA),2007,Truck/Lorry (Private),21037,2954,23991
TOTAL (ALL INDIA),2007,Bus (Government),3000,713,3713
TOTAL (ALL INDIA),2007,Bus (Private),7547,1604,9151
TOTAL (ALL INDIA),2007,Tempo/Vans (Government),190,45,235
TOTAL (ALL INDIA),2007,Tempo/Vans (Private),4738,1051,5789
TOTAL (ALL INDIA),2007,Jeep (Government),294,59,353
TOTAL (ALL INDIA),2007,Jeep (Private),7735,1584,9319
TOTAL (ALL INDIA),2007,Car (Government),140,29,169
TOTAL (ALL INDIA),2007,Car (Private),8161,1602,9763
TOTAL (ALL INDIA),2007,Three Wheeler,5322,1156,6478
TOTAL (ALL INDIA),2007,Two Wheeler,19082,2790,21872
TOTAL (ALL INDIA),2007,Bicycle,2870,235,3105
TOTAL (ALL INDIA),2007,Pedestrian,8351,1774,10125
TOTAL (ALL INDIA),2007,Others (Please Specify),8379,1490,9869
TOTAL (ALL INDIA),2007,Total Deaths (Persons),97398,17192,114590
TOTAL (ALL INDIA),2007,Total Truck/Lorry,21589,3060,24649
TOTAL (ALL INDIA),2007,Total Bus,10547,2317,12864
TOTAL (ALL INDIA),2007,Total Tempo/Vans,4928,1096,6024
TOTAL (ALL INDIA),2007,Total Jeep,8029,1643,9672
TOTAL (ALL INDIA),2007,Total Car,8301,1631,9932
TOTAL (ALL INDIA),2008,Truck/Lorry (Government),429,58,487
TOTAL (ALL INDIA),2008,Truck/Lorry (Private),21817,2831,24648
TOTAL (ALL INDIA),2008,Bus (Government),3342,1039,4381
TOTAL (ALL INDIA),2008,Bus (Private),6578,1592,8170
TOTAL (ALL INDIA),2008,Tempo/Vans (Government),110,13,123
TOTAL (ALL INDIA),2008,Tempo/Vans (Private),5085,1073,6158
TOTAL (ALL INDIA),2008,Jeep (Government),251,49,300
TOTAL (ALL INDIA),2008,Jeep (Private),7773,1527,9300
TOTAL (ALL INDIA),2008,Car (Government),185,59,244
TOTAL (ALL INDIA),2008,Car (Private),8386,1592,9978
TOTAL (ALL INDIA),2008,Three Wheeler,5329,1216,6545
TOTAL (ALL INDIA),2008,Two Wheeler,20420,3132,23552
TOTAL (ALL INDIA),2008,Bicycle,2956,540,3496
TOTAL (ALL INDIA),2008,Pedestrian,8488,1836,10324
TOTAL (ALL INDIA),2008,Others (Please Specify),9151,1382,10533
TOTAL (ALL INDIA),2008,Total Deaths (Persons),100300,17939,118239
TOTAL (ALL INDIA),2008,Total Truck/Lorry,22246,2889,25135
TOTAL (ALL INDIA),2008,Total Bus,9920,2631,12551
TOTAL (ALL INDIA),2008,Total Tempo/Vans,5195,1086,6281
TOTAL (ALL INDIA),2008,Total Jeep,8024,1576,9600
TOTAL (ALL INDIA),2008,Total Car,8571,1651,10222
TOTAL (ALL INDIA),2009,Truck/Lorry (Government),541,69,610
TOTAL (ALL INDIA),2009,Truck/Lorry (Private),21749,2777,24526
TOTAL (ALL INDIA),2009,Bus (Government),3048,783,3831
TOTAL (ALL INDIA),2009,Bus (Private),7288,1702,8990
TOTAL (ALL INDIA),2009,Tempo/Vans (Government),364,75,439
TOTAL (ALL INDIA),2009,Tempo/Vans (Private),5895,1091,6986
TOTAL (ALL INDIA),2009,Jeep (Government),195,31,226
TOTAL (ALL INDIA),2009,Jeep (Private),7906,1688,9594
TOTAL (ALL INDIA),2009,Car (Government),267,34,301
TOTAL (ALL INDIA),2009,Car (Private),9623,1758,11381
TOTAL (ALL INDIA),2009,Three Wheeler,5364,1252,6616
TOTAL (ALL INDIA),2009,Two Wheeler,23180,3039,26219
TOTAL (ALL INDIA),2009,Bicycle,3024,243,3267
TOTAL (ALL INDIA),2009,Pedestrian,9077,2032,11109
TOTAL (ALL INDIA),2009,Others (Please Specify),10888,1913,12801
TOTAL (ALL INDIA),2009,Total Deaths (Persons),108409,18487,126896
TOTAL (ALL INDIA),2009,Total Truck/Lorry,22290,2846,25136
TOTAL (ALL INDIA),2009,Total Bus,10336,2485,12821
TOTAL (ALL INDIA),2009,Total Tempo/Vans,6259,1166,7425
TOTAL (ALL INDIA),2009,Total Jeep,8101,1719,9820
TOTAL (ALL INDIA),2009,Total Car,9890,1792,11682
TOTAL (ALL INDIA),2010,Truck/Lorry (Government),718,128,846
TOTAL (ALL INDIA),2010,Truck/Lorry (Private),22728,3226,25954
TOTAL (ALL INDIA),2010,Bus (Government),3366,845,4211
TOTAL (ALL INDIA),2010,Bus (Private),7082,1710,8792
TOTAL (ALL INDIA),2010,Tempo/Vans (Government),169,24,193
TOTAL (ALL INDIA),2010,Tempo/Vans (Private),6855,1380,8235
TOTAL (ALL INDIA),2010,Jeep (Government),229,43,272
TOTAL (ALL INDIA),2010,Jeep (Private),7998,1754,9752
TOTAL (ALL INDIA),2010,Car (Government),258,37,295
TOTAL (ALL INDIA),2010,Car (Private),9904,2005,11909
TOTAL (ALL INDIA),2010,Three Wheeler,5954,1296,7250
TOTAL (ALL INDIA),2010,Two Wheeler,24865,3369,28234
TOTAL (ALL INDIA),2010,Bicycle,2955,269,3224
TOTAL (ALL INDIA),2010,Pedestrian,9983,2159,12142
TOTAL (ALL INDIA),2010,Others (Please Specify),10871,1758,12629
TOTAL (ALL INDIA),2010,Total Deaths (Persons),113935,20003,133938
TOTAL (ALL INDIA),2010,Total Truck/Lorry,23446,3354,26800
TOTAL (ALL INDIA),2010,Total Bus,10448,2555,13003
TOTAL (ALL INDIA),2010,Total Tempo/Vans,7024,1404,8428
TOTAL (ALL INDIA),2010,Total Jeep,8227,1797,10024
TOTAL (ALL INDIA),2010,Total Car,10162,2042,12204
TOTAL (ALL INDIA),2011,Truck/Lorry (Government),343,65,408
TOTAL (ALL INDIA),2011,Truck/Lorry (Private),23241,2952,26193
TOTAL (ALL INDIA),2011,Bus (Government),3254,637,3891
TOTAL (ALL INDIA),2011,Bus (Private),6951,1659,8610
TOTAL (ALL INDIA),2011,Tempo/Vans (Government),231,40,271
TOTAL (ALL INDIA),2011,Tempo/Vans (Private),6875,1394,8269
TOTAL (ALL INDIA),2011,Jeep (Government),186,26,212
TOTAL (ALL INDIA),2011,Jeep (Private),7674,1579,9253
TOTAL (ALL INDIA),2011,Car (Government),294,55,349
TOTAL (ALL INDIA),2011,Car (Private),10884,2147,13031
TOTAL (ALL INDIA),2011,Three Wheeler,5476,1316,6792
TOTAL (ALL INDIA),2011,Two Wheeler,26928,3696,30624
TOTAL (ALL INDIA),2011,Bicycle,2865,269,3134
TOTAL (ALL INDIA),2011,Pedestrian,10114,2286,12400
TOTAL (ALL INDIA),2011,Others (Please Specify),11313,2084,13397
TOTAL (ALL INDIA),2011,Total Deaths (Persons),116629,20205,136834
TOTAL (ALL INDIA),2011,Total Truck/Lorry,23584,3017,26601
TOTAL (ALL INDIA),2011,Total Bus,10205,2296,12501
TOTAL (ALL INDIA),2011,Total Tempo/Vans,7106,1434,8540
TOTAL (ALL INDIA),2011,Total Jeep,7860,1605,9465
TOTAL (ALL INDIA),2011,Total Car,11178,2202,13380
TOTAL (ALL INDIA),2012,Truck/Lorry (Government),388,77,465
TOTAL (ALL INDIA),2012,Truck/Lorry (Private),23135,3078,26213
TOTAL (ALL INDIA),2012,Bus (Government),3708,716,4424
TOTAL (ALL INDIA),2012,Bus (Private),6945,1707,8652
TOTAL (ALL INDIA),2012,Tempo/Vans (Government),100,30,130
TOTAL (ALL INDIA),2012,Tempo/Vans (Private),6456,1299,7755
TOTAL (ALL INDIA),2012,Jeep (Government),207,41,248
TOTAL (ALL INDIA),2012,Jeep (Private),7461,1564,9025
TOTAL (ALL INDIA),2012,Car (Government),354,63,417
TOTAL (ALL INDIA),2012,Car (Private),11632,2061,13693
TOTAL (ALL INDIA),2012,Three Wheeler,5461,1276,6737
TOTAL (ALL INDIA),2012,Two Wheeler,28524,3794,32318
TOTAL (ALL INDIA),2012,Bicycle,2871,198,3069
TOTAL (ALL INDIA),2012,Pedestrian,9067,2504,11571
TOTAL (ALL INDIA),2012,Others (Please Specify),12224,2150,14374
TOTAL (ALL INDIA),2012,Total Deaths (Persons),118533,20558,139091
TOTAL (ALL INDIA),2012,Total Truck/Lorry,23523,3155,26678
TOTAL (ALL INDIA),2012,Total Bus,10653,2423,13076
TOTAL (ALL INDIA),2012,Total Tempo/Vans,6556,1329,7885
TOTAL (ALL INDIA),2012,Total Jeep,7668,1605,9273
TOTAL (ALL INDIA),2012,Total Car,11986,2124,14110
